10 10 10 10 10 10 10 10 10 10 10 10 10 10 10 10 10 10 10 10 10 10 10 10 10 10 10 10 10 10 10 10 10 10 10 10 10 10 10 10 10 10 10 10 10 10 10 10 10 10 10 10 10 10 10 10 10 10 10 10 10 10 10 10 10 10 10 10 10 10 10 10 10 10 10 10 10 10 10 10 10 10 10 10 10 10 10 10 10 10 10 10 10 10 10 10 10 10 10 10 
10 10 10 10 10 10 10 10 10 10 10 10 10 10 10 10 10 10 10 10 10 10 10 10 10 10 10 10 10 10 10 10 10 10 10 10 10 10 10 10 10 10 10 10 10 10 10 10 10 10 10 10 10 10 10 10 10 10 10 10 10 10 10 10 10 10 10 10 10 10 10 10 10 10 10 10 10 10 10 10 10 10 10 10 10 10 10 10 10 10 10 10 10 10 10 10 10 10 10 10 
10 10 10 10 10 10 10 10 10 10 10 10 10 10 10 10 10 10 10 10 10 10 10 10 10 10 10 10 10 10 10 10 10 10 10 10 10 10 10 10 10 10 10 10 10 10 10 10 10 10 10 10 10 10 10 10 10 10 10 10 10 10 10 10 10 10 10 10 10 10 10 10 10 10 10 10 10 10 10 10 10 10 10 10 10 10 10 10 10 10 10 10 10 10 10 10 10 10 10 10 
10 10 10 10 10 10 10 10 10 10 10 10 10 10 10 10 10 10 10 10 10 10 10 10 10 10 10 10 10 10 10 10 10 10 10 10 10 10 10 10 10 10 10 10 10 10 10 10 10 10 10 10 10 10 10 10 10 10 10 10 10 10 10 10 10 10 10 10 10 10 10 10 10 10 10 10 10 10 10 10 10 10 10 10 10 10 10 10 10 10 10 10 10 10 10 10 10 10 10 10 
10 10 10 10 10 10 10 10 10 10 10 10 10 10 10 10 10 10 10 10 10 10 10 10 10 10 10 10 10 10 10 10 10 10 10 10 10 10 10 10 10 10 10 10 10 10 10 10 10 10 10 10 10 10 10 10 10 10 10 10 10 10 10 10 10 10 10 10 10 10 10 10 10 10 10 10 10 10 10 10 10 10 10 10 10 10 10 10 10 10 10 10 10 10 10 10 10 10 10 10 
10 10 10 10 10 10 10 10 10 10 10 10 10 10 10 10 10 10 10 10 10 10 10 10 10 10 10 10 10 10 10 10 10 10 10 10 10 10 10 10 10 10 10 10 10 10 10 10 10 10 10 10 10 10 10 10 10 10 10 10 10 10 10 10 10 10 10 10 10 10 10 10 10 10 10 10 10 10 10 10 10 10 10 10 10 10 10 10 10 10 10 10 10 10 10 10 10 10 10 10 
10 10 10 10 10 10 10 10 10 10 10 10 10 10 10 10 10 10 10 10 10 10 10 10 10 10 10 10 10 10 10 10 10 10 10 10 10 10 10 10 10 10 10 10 10 10 10 10 10 10 10 10 10 10 10 10 10 10 10 10 10 10 10 10 10 10 10 10 10 10 10 10 10 10 10 10 10 10 10 10 10 10 10 10 10 10 10 10 10 10 10 10 10 10 10 10 10 10 10 10 
10 10 10 10 10 10 10 10 10 10 10 10 10 10 10 10 10 10 10 10 10 10 10 10 10 10 10 10 10 10 10 10 10 10 10 10 10 10 10 10 10 10 10 10 10 10 10 10 10 10 10 10 10 10 10 10 10 11 11 11 11 11 11 11 11 11 11 11 11 11 11 11 11 11 11 11 11 11 11 11 11 11 11 11 11 11 11 11 11 11 11 11 10 10 10 10 10 10 10 10 
10 10 10 10 10 10 10 10 10 10 10 10 10 10 10 10 11 11 11 11 11 11 11 11 10 10 10 10 10 10 10 10 10 10 10 10 10 10 10 10 10 10 10 10 10 10 10 10 10 10 10 10 10 10 10 10 11 11 0 11 10 10 11 0 0 0 11 11 0 0 0 0 0 11 10 10 11 0 0 0 0 0 11 11 0 0 0 0 0 0 0 11 11 10 10 10 10 10 10 10 
10 10 10 10 10 10 10 10 10 10 10 10 10 10 10 11 11 0 0 1 3 0 0 11 11 10 10 10 10 10 10 10 10 10 10 10 10 10 10 10 10 10 10 10 10 10 10 10 10 10 10 10 10 10 10 10 11 0 0 0 11 11 0 0 0 0 0 0 0 11 11 0 0 0 11 11 0 0 11 11 0 0 0 0 0 0 0 0 1 2 3 0 11 10 10 10 10 10 10 10 
10 10 10 10 10 10 10 10 10 10 10 10 10 11 11 11 0 0 11 7 5 11 0 0 11 11 11 10 10 10 10 10 10 10 10 10 10 10 10 10 10 10 10 10 10 10 10 10 10 10 10 10 10 10 10 10 11 0 0 0 0 0 0 0 11 11 0 0 11 10 10 11 0 0 0 0 0 11 10 10 11 0 0 0 11 11 0 0 8 9 4 0 11 10 10 10 10 10 10 10 
10 10 10 10 10 10 10 10 10 10 10 10 11 11 0 0 0 0 11 11 11 11 0 0 0 0 11 11 10 10 10 10 10 10 10 10 10 10 10 10 10 10 10 10 10 10 10 10 10 10 10 10 10 10 10 10 11 11 11 0 0 0 0 11 10 10 11 0 11 10 10 11 0 0 0 0 0 11 10 10 11 0 0 11 10 10 11 0 7 6 5 0 11 10 10 10 10 10 10 10 
10 10 10 10 10 10 10 10 10 10 10 11 11 0 0 1 2 2 2 2 2 2 2 2 3 0 0 11 11 10 10 10 10 10 10 10 10 10 10 10 10 10 10 10 10 10 10 10 10 10 10 10 10 10 10 10 11 10 10 11 0 0 0 11 10 10 11 0 0 11 11 0 0 0 0 0 0 0 11 11 0 0 0 11 10 10 11 0 0 0 0 0 11 10 10 10 10 10 10 10 
10 10 10 10 10 10 10 10 10 10 11 11 0 0 0 8 9 9 9 9 9 9 9 9 4 0 0 0 11 11 10 10 10 10 10 10 10 10 10 10 10 10 10 10 10 10 10 10 10 10 10 10 10 10 10 10 11 10 10 11 0 0 0 0 11 11 0 0 0 0 0 0 0 0 11 11 0 0 0 0 0 0 0 0 11 11 0 0 0 0 0 11 11 10 10 10 10 10 10 10 
10 10 10 10 10 10 10 10 10 11 11 0 0 0 0 8 9 9 9 9 9 9 9 9 4 0 0 0 0 11 11 10 10 10 10 10 10 10 10 10 10 10 10 10 10 10 10 10 10 10 10 10 10 10 10 10 11 11 11 0 0 0 0 0 0 0 0 0 11 11 0 0 0 11 10 10 11 0 0 0 0 0 0 0 0 0 0 11 11 0 0 11 11 10 10 10 10 10 10 10 
10 10 10 10 10 10 10 10 10 11 0 0 11 11 0 8 9 9 9 9 9 9 9 9 4 0 11 11 0 0 11 10 10 10 10 10 10 10 10 10 10 10 10 10 10 10 10 10 10 10 10 10 10 10 10 10 11 0 0 0 0 0 11 11 0 0 0 11 10 10 11 0 0 11 10 10 11 0 0 0 11 11 0 0 0 0 11 10 10 11 0 0 11 10 10 10 10 10 10 10 
10 10 10 10 10 10 10 10 10 11 0 0 11 0 0 8 9 9 9 9 9 9 9 9 4 0 0 11 0 0 11 10 10 10 10 10 10 10 10 10 10 10 10 10 10 10 10 10 10 10 10 10 10 10 10 10 11 11 11 0 0 11 10 10 11 0 0 11 10 10 11 0 0 0 11 11 0 0 0 11 10 10 11 0 0 0 11 10 10 11 0 0 11 10 10 10 10 10 10 10 
10 10 10 10 10 10 10 10 10 11 0 0 11 0 0 8 9 9 9 9 9 9 9 9 4 0 0 11 0 0 11 10 10 10 10 10 10 10 10 10 10 10 10 10 10 10 10 10 10 10 10 10 10 10 10 10 11 10 10 11 0 11 10 10 11 0 0 0 11 11 0 0 0 0 0 0 0 0 0 11 10 10 11 0 0 0 0 11 11 0 0 11 11 10 10 10 10 10 10 10 
10 10 10 10 10 10 10 10 10 11 0 0 11 11 0 8 9 9 9 9 9 9 9 9 4 0 11 11 0 0 11 10 10 10 10 10 10 10 10 10 10 10 10 10 10 10 10 10 10 10 10 10 10 10 10 10 11 10 10 11 0 0 11 11 0 0 0 0 0 0 0 0 11 11 0 0 0 0 0 0 11 11 0 0 11 11 0 0 0 0 11 10 11 10 10 10 10 10 10 10 
10 10 10 10 10 10 10 10 10 11 11 0 0 0 0 8 9 9 9 9 9 9 9 9 4 0 0 0 0 11 11 10 10 10 10 10 10 10 10 10 10 10 10 10 10 10 10 10 10 10 10 10 10 10 10 10 11 11 11 0 0 0 0 0 0 0 0 0 0 0 0 11 10 10 11 0 0 11 11 0 0 0 0 11 10 10 11 0 0 0 11 10 11 10 10 10 10 10 10 10 
10 10 10 10 10 10 10 10 10 10 11 0 0 0 0 7 6 6 6 6 6 6 6 6 5 0 0 0 0 11 10 10 10 10 10 10 10 10 10 10 10 10 10 10 10 10 10 10 10 10 10 10 10 10 10 10 11 0 1 2 3 0 0 11 11 0 0 0 0 0 0 11 10 10 11 0 11 10 10 11 0 0 0 11 10 10 11 0 0 0 0 11 11 10 10 10 10 10 10 10 
10 10 10 10 10 10 10 10 10 10 11 11 0 0 0 0 0 11 0 0 0 0 11 0 0 0 0 0 11 11 10 10 10 10 10 10 10 10 10 10 10 10 10 10 10 10 10 10 10 10 10 10 10 10 10 10 11 0 8 9 4 0 11 10 10 11 0 0 11 11 0 0 11 11 0 0 11 10 10 11 0 0 0 0 11 11 0 0 0 0 0 0 11 10 10 10 10 10 10 10 
10 10 10 10 10 10 10 10 10 10 10 11 11 11 0 0 0 11 11 11 11 11 11 0 0 0 11 11 11 10 10 10 10 10 10 10 10 10 10 10 10 10 10 10 10 10 10 10 10 10 10 10 10 10 10 10 11 11 7 6 5 0 11 10 10 11 0 11 10 10 11 0 0 0 0 0 0 11 11 0 0 0 0 0 0 0 0 0 11 11 0 11 11 10 10 10 10 10 10 10 
10 10 10 10 10 10 10 10 10 10 10 10 10 11 11 11 0 0 0 0 0 0 0 0 11 11 11 10 10 10 10 10 10 10 10 10 10 10 10 10 10 10 10 10 10 10 10 10 10 10 10 10 10 10 10 10 10 11 11 11 11 11 11 11 11 11 11 11 11 11 11 11 11 11 11 11 11 11 11 11 11 11 11 11 11 11 11 11 11 11 11 11 10 10 10 10 10 10 10 10 
10 10 10 10 10 10 10 10 10 10 10 10 10 10 10 11 11 11 0 1 3 0 11 11 11 10 10 10 10 10 10 10 10 10 10 10 10 10 10 10 10 10 10 10 10 10 10 10 10 10 10 10 10 10 10 10 10 10 10 10 10 10 10 10 10 10 10 10 10 10 10 10 10 10 10 10 10 10 10 10 10 10 10 10 10 10 10 10 10 10 10 10 10 10 10 10 10 10 10 10 
10 10 10 10 10 10 10 10 10 10 10 10 10 10 10 10 10 11 0 8 4 0 11 10 10 10 10 10 10 10 10 10 10 10 10 10 10 10 10 10 10 10 10 10 10 10 10 10 10 10 10 10 10 10 10 10 10 10 10 10 10 10 10 10 10 10 10 10 10 10 10 10 10 10 10 10 10 10 10 10 10 10 10 10 10 10 10 10 10 10 10 10 10 10 10 10 10 10 10 10 
10 10 10 10 10 10 10 10 10 10 10 10 10 10 10 10 10 11 0 8 4 0 11 10 10 10 10 10 10 10 10 10 10 10 10 10 10 10 10 10 10 10 10 10 10 10 10 10 10 10 10 10 10 10 10 10 10 10 10 10 10 10 10 10 10 10 10 10 10 10 10 10 10 10 10 10 10 10 10 10 10 10 10 10 10 10 10 10 10 10 10 10 10 10 10 10 10 10 10 10 
10 10 10 10 10 10 10 10 10 10 10 10 10 10 10 10 10 11 0 8 4 0 11 10 10 10 10 10 10 10 10 10 10 10 10 10 10 10 10 10 10 10 10 10 10 10 10 10 10 10 10 10 10 10 10 10 10 10 10 10 10 10 10 10 10 10 10 10 10 10 10 10 10 10 10 10 10 10 10 10 10 10 10 10 10 10 10 10 10 10 10 10 10 10 10 10 10 10 10 10 
10 10 10 10 10 10 10 10 10 10 10 10 10 10 10 10 10 11 0 8 4 0 11 10 10 10 10 10 10 10 10 10 10 10 10 10 10 10 10 10 10 10 10 10 10 10 10 10 10 10 10 10 10 10 10 10 10 10 10 10 10 10 10 10 10 10 10 10 10 10 10 10 10 10 10 10 10 10 10 10 10 10 10 10 10 10 10 10 10 10 10 10 10 10 10 10 10 10 10 10 
10 10 10 10 10 10 10 10 10 10 10 10 10 10 10 10 10 11 0 8 4 0 11 10 10 10 10 10 10 10 10 10 10 10 10 10 10 10 10 10 10 10 11 11 11 11 11 11 11 11 11 11 10 10 10 10 10 10 10 10 10 10 10 10 10 10 10 10 10 10 10 10 10 10 10 10 10 10 10 10 10 10 10 10 10 10 10 10 10 10 10 10 10 10 10 10 10 10 10 10 
10 10 10 10 10 10 10 10 10 10 10 10 10 10 10 10 10 11 0 8 4 0 11 10 10 10 10 10 10 10 10 10 10 10 10 10 10 10 10 10 10 10 11 0 0 0 0 0 0 0 0 11 10 10 10 10 10 10 10 10 10 10 10 10 10 10 10 10 10 10 10 10 10 10 10 10 10 10 10 10 10 10 10 10 10 10 10 10 10 10 10 10 10 10 10 10 10 10 10 10 
10 10 10 10 10 10 10 10 10 10 10 10 10 10 10 10 10 11 0 7 5 0 11 10 10 10 10 10 10 10 10 10 10 10 11 11 11 11 11 11 11 11 11 0 1 2 2 2 2 3 0 11 10 10 10 10 10 10 10 10 10 10 10 10 10 10 10 10 10 10 10 10 10 10 10 10 10 10 10 10 10 10 10 10 10 10 10 10 10 10 10 10 10 10 10 10 10 10 10 10 
10 10 10 10 10 10 10 10 10 10 10 10 10 10 10 10 10 11 11 0 0 11 11 10 10 10 10 10 10 10 10 10 10 10 11 0 0 0 0 0 0 0 0 0 8 9 9 9 9 4 0 11 10 10 10 10 10 10 10 10 10 10 10 10 10 10 10 10 10 10 10 10 10 10 10 10 10 10 10 10 10 10 10 10 10 10 10 10 10 10 10 10 10 10 10 10 10 10 10 10 
10 10 10 10 10 10 10 10 10 10 10 10 10 10 10 10 10 10 11 11 11 11 10 10 10 10 10 10 10 10 10 10 10 10 11 0 11 11 11 11 11 11 11 0 7 6 6 6 6 5 0 11 10 10 10 10 10 10 10 10 10 10 10 10 10 10 10 11 11 11 11 11 10 10 10 10 10 10 10 10 10 10 10 10 10 10 10 10 10 10 10 10 10 10 10 10 10 10 10 10 
10 10 10 10 10 10 10 10 10 10 10 10 10 10 10 10 10 10 10 10 10 10 10 10 10 10 10 10 10 10 10 10 10 10 11 0 11 10 10 10 10 10 11 0 0 0 0 0 0 0 0 11 10 10 10 10 10 10 10 10 10 10 10 10 10 10 11 11 0 0 0 11 11 10 10 10 10 10 10 10 10 10 10 10 10 10 10 10 10 10 10 10 10 10 10 10 10 10 10 10 
10 10 10 10 10 10 10 10 10 10 10 10 10 10 10 10 10 10 10 10 10 10 10 10 10 10 10 10 10 10 10 10 10 10 11 0 11 10 10 10 11 11 11 11 11 11 11 11 11 11 11 11 11 11 11 11 11 11 11 11 11 10 10 10 10 11 11 0 1 2 3 0 11 11 10 10 10 10 10 10 10 10 10 10 10 10 10 10 10 10 10 10 10 10 10 10 10 10 10 10 
10 10 10 10 10 10 10 10 10 10 10 10 10 10 10 10 10 10 10 10 10 10 10 10 10 10 10 10 10 10 10 10 10 10 11 0 11 10 10 10 11 0 0 0 0 0 11 11 0 0 0 0 0 11 11 0 0 0 0 0 11 10 10 10 10 11 0 0 8 9 4 0 0 11 10 10 10 10 10 10 10 10 10 10 10 10 10 10 10 10 10 10 10 10 10 10 10 10 10 10 
10 10 10 10 10 10 10 10 10 10 10 10 10 10 10 10 10 10 10 10 10 10 10 10 10 10 10 10 10 10 10 10 10 10 11 0 11 10 10 10 11 0 1 2 3 0 11 11 0 1 2 3 0 11 11 0 1 2 3 0 11 10 10 10 10 11 11 0 7 6 5 0 11 11 10 10 10 10 10 10 10 10 10 10 10 10 10 10 10 10 10 10 10 10 10 10 10 10 10 10 
10 10 10 10 10 10 10 10 10 10 10 10 10 10 10 10 10 10 10 10 10 10 10 10 10 10 10 10 10 10 10 10 10 10 11 0 11 10 10 10 11 0 7 6 5 0 11 11 0 7 6 5 0 11 11 0 7 6 5 0 11 10 10 10 10 10 11 11 0 0 0 11 11 10 10 10 10 10 10 10 10 10 10 10 10 10 10 10 10 10 10 10 10 10 10 10 10 10 10 10 
10 10 10 10 10 10 10 10 10 10 10 10 10 10 10 10 10 10 10 10 10 10 10 10 10 10 10 10 10 10 10 10 10 10 11 0 11 10 10 10 11 0 0 0 0 0 11 11 0 0 0 0 0 11 11 0 0 0 0 0 11 10 10 10 10 10 10 11 11 0 11 11 10 10 10 10 10 10 10 10 10 10 10 10 10 10 10 10 10 10 10 10 10 10 10 10 10 10 10 10 
10 10 10 10 10 10 10 10 10 10 10 10 10 10 10 10 10 10 10 10 10 10 10 10 10 10 10 10 10 10 10 10 10 10 11 0 11 10 10 10 11 11 11 0 11 11 11 11 11 11 0 11 11 11 11 11 11 0 11 11 11 10 10 10 10 10 10 10 11 0 11 10 10 10 10 10 10 10 10 10 10 10 10 10 10 10 10 10 10 10 10 10 10 10 10 10 10 10 10 10 
10 10 10 10 10 10 10 10 10 10 10 10 10 10 10 10 10 10 10 10 10 10 10 10 10 10 10 10 10 10 10 10 10 10 11 0 11 10 10 10 10 11 0 0 0 11 10 10 11 0 0 0 11 10 10 11 0 0 0 11 10 10 10 10 10 10 10 10 11 0 11 10 10 10 10 10 10 10 10 10 10 10 10 10 10 10 10 10 10 10 10 10 10 10 10 10 10 10 10 10 
10 10 10 10 10 10 10 10 10 10 10 10 10 10 10 10 10 10 10 10 10 10 10 10 10 10 10 10 10 10 10 10 10 10 11 0 11 10 10 10 10 11 0 0 0 11 10 10 11 0 0 0 11 10 10 11 0 0 0 11 10 10 10 10 10 10 10 10 11 0 11 10 10 10 10 10 10 10 10 10 10 10 10 10 10 10 10 10 10 10 10 10 10 10 10 10 10 10 10 10 
10 10 10 10 10 10 10 10 10 10 10 10 10 10 10 10 10 10 10 10 10 10 10 10 10 10 10 10 10 10 10 10 10 10 11 0 11 11 11 11 11 11 0 0 0 11 10 10 11 0 0 0 11 10 10 11 0 0 0 11 11 11 11 11 11 11 11 11 11 0 11 10 10 10 10 10 10 10 10 10 10 10 10 10 10 10 10 10 10 10 10 10 10 10 10 10 10 10 10 10 
10 10 10 10 10 10 10 10 10 10 10 10 10 10 10 10 10 10 10 10 10 10 10 10 10 10 10 10 10 10 10 10 10 10 11 0 0 0 0 0 0 0 0 0 0 11 10 10 11 0 0 0 11 10 10 11 0 0 0 0 0 0 0 0 0 0 0 0 0 0 11 10 10 10 10 10 10 10 10 10 10 10 10 10 10 10 10 11 11 11 11 11 11 10 10 10 10 10 10 10 
10 10 10 10 10 10 10 10 10 10 10 10 10 10 10 10 10 10 10 10 10 10 10 10 10 10 10 10 10 10 10 10 10 10 11 11 11 11 11 11 11 11 0 0 0 11 10 10 11 0 0 0 11 10 10 11 0 0 0 11 11 11 11 11 11 11 11 11 11 11 11 10 10 10 10 10 10 10 10 10 10 10 10 10 10 10 11 11 0 0 0 0 11 10 10 10 10 10 10 10 
10 10 10 10 10 10 10 10 10 10 10 10 10 10 10 10 10 10 10 10 10 10 10 10 10 10 10 10 10 10 10 10 10 10 10 10 10 10 10 10 10 11 0 0 0 11 10 10 11 0 0 0 11 10 10 11 0 0 0 11 10 10 10 10 10 10 10 10 10 10 10 10 10 10 10 10 11 11 11 11 11 11 11 11 11 11 11 0 1 2 3 0 11 10 10 10 10 10 10 10 
10 10 10 10 10 10 10 10 10 10 10 10 10 10 10 10 10 10 10 10 10 10 10 10 10 10 10 10 10 10 10 10 10 10 10 10 10 10 10 10 11 11 0 0 0 11 11 11 11 0 0 0 11 11 11 11 0 0 0 11 11 10 10 10 10 10 10 10 10 10 10 10 10 10 10 11 11 0 0 0 0 0 0 0 0 0 0 0 8 9 4 0 11 10 10 10 10 10 10 10 
10 10 10 10 10 10 10 10 10 10 10 10 10 10 10 10 10 10 10 10 10 10 10 10 10 10 10 10 10 10 10 10 10 10 11 11 11 11 11 11 11 0 0 0 0 0 11 11 0 0 0 0 0 11 11 0 0 0 0 0 11 11 11 11 11 11 11 11 11 11 11 11 11 11 11 11 0 0 1 2 2 2 2 2 2 2 3 0 8 9 4 0 11 10 10 10 10 10 10 10 
10 10 10 10 10 10 10 10 10 10 10 10 10 10 10 10 10 10 10 10 10 10 10 10 10 10 10 10 10 10 10 10 10 10 11 0 0 0 0 0 0 0 0 0 0 0 0 0 0 1 2 3 0 0 0 0 0 0 0 0 0 0 0 0 0 0 0 0 0 0 0 0 0 0 0 11 0 0 8 9 9 9 9 9 9 9 4 0 8 9 4 0 11 10 10 10 10 10 10 10 
10 10 10 10 10 10 10 10 10 10 10 10 10 10 10 10 10 10 10 10 10 10 10 10 10 10 10 10 10 10 10 10 10 10 11 0 0 0 0 0 0 0 0 0 0 0 0 0 0 8 9 4 0 0 0 0 0 0 0 0 0 0 0 0 0 0 0 0 0 0 0 0 0 0 0 0 0 0 8 9 9 9 9 9 9 9 4 0 8 9 4 0 11 10 10 10 10 10 10 10 
10 10 10 10 10 10 10 10 10 10 10 10 10 10 10 10 10 10 10 10 10 10 10 10 10 10 10 10 10 10 10 10 10 10 11 0 0 0 0 0 0 0 0 0 0 0 0 0 0 7 6 5 0 0 0 0 0 0 0 0 0 0 0 0 0 0 0 0 0 0 0 0 0 0 0 11 0 0 8 9 9 9 9 9 9 9 4 0 8 9 4 0 11 10 10 10 10 10 10 10 
10 10 10 10 10 10 10 10 10 10 10 10 10 10 10 10 10 10 10 10 10 10 10 10 10 10 10 10 10 10 10 10 10 10 11 0 0 0 11 11 11 11 11 11 11 11 11 11 0 0 0 0 0 11 11 11 11 11 11 11 11 11 11 11 11 11 11 11 11 11 11 11 11 11 11 11 0 0 7 6 6 6 6 6 6 6 5 0 8 9 4 0 11 10 10 10 10 10 10 10 
10 10 10 10 10 10 10 10 10 10 10 10 10 10 10 10 10 10 10 10 10 10 10 10 10 10 10 10 10 10 10 10 10 10 11 0 0 0 11 10 10 10 10 10 10 10 10 11 11 0 0 0 11 11 10 10 11 9 11 10 10 10 10 10 10 10 10 10 10 10 10 10 10 10 10 11 11 0 0 0 0 0 0 0 0 0 0 0 8 9 4 0 11 10 10 10 10 10 10 10 
10 10 10 10 10 10 10 10 10 10 10 10 10 10 10 10 10 10 10 10 10 10 10 10 10 10 10 10 10 10 10 10 10 10 11 0 0 0 11 10 10 10 10 10 10 10 10 10 11 0 0 0 11 10 10 10 11 0 11 10 10 10 10 10 10 10 10 10 10 10 10 10 10 10 10 10 11 11 11 11 11 11 11 11 11 11 11 0 7 6 5 0 11 10 10 10 10 10 10 10 
10 10 10 10 10 10 10 10 10 10 10 10 10 10 10 10 10 10 10 10 10 10 10 10 10 10 10 10 10 10 10 10 10 10 11 0 0 0 11 10 10 10 10 10 10 10 10 10 11 0 0 0 11 10 11 11 11 0 11 11 11 11 11 11 11 11 11 11 11 11 11 11 11 11 11 10 10 10 10 10 10 10 10 10 10 10 11 11 0 0 0 0 11 10 10 10 10 10 10 10 
10 10 10 10 10 10 10 10 10 10 10 10 10 10 10 10 10 10 10 10 10 10 10 10 10 10 10 10 10 10 10 10 10 10 11 0 0 0 11 10 10 10 10 10 10 10 10 10 11 0 0 0 11 10 11 0 0 0 0 0 0 0 0 0 0 0 0 0 0 11 0 0 0 0 11 11 11 11 11 11 11 11 11 11 11 10 10 11 11 11 11 11 11 10 10 10 10 10 10 10 
10 10 10 10 10 10 10 10 10 10 10 10 10 10 10 10 10 10 10 10 10 10 10 10 10 10 10 10 10 10 10 10 10 10 11 0 0 0 11 10 10 10 10 10 10 10 10 10 11 0 0 0 11 10 11 11 11 11 11 11 0 11 11 11 11 11 11 11 0 11 0 11 11 0 0 0 0 0 0 0 0 0 0 0 11 11 10 10 10 10 10 10 11 11 10 10 10 10 10 10 
10 10 10 10 10 10 10 10 10 10 10 10 10 10 10 10 10 10 10 10 10 10 10 10 10 10 10 10 10 10 10 10 10 10 11 0 0 0 11 10 10 10 10 10 10 10 10 10 11 0 0 0 11 10 10 10 10 10 10 11 0 11 1 2 3 11 0 11 0 11 0 0 11 0 11 11 11 11 11 11 11 11 11 0 0 11 11 11 11 11 11 11 11 11 10 10 10 10 10 10 
10 10 10 10 10 10 10 10 10 10 10 10 10 10 10 10 10 10 10 10 10 10 10 10 10 10 10 10 10 10 10 10 10 10 11 0 0 0 11 10 10 10 10 10 10 10 10 10 11 0 0 0 11 11 10 10 10 10 10 11 0 11 7 6 5 11 0 11 0 11 11 0 11 0 11 9 11 10 10 10 11 0 11 11 0 0 0 0 0 0 0 0 11 10 10 10 10 10 10 10 
10 10 10 10 10 10 10 10 10 10 10 10 10 10 10 10 10 10 10 10 10 10 10 10 10 10 10 10 10 10 10 10 10 11 11 11 0 11 11 11 10 10 10 10 10 10 10 10 11 0 0 0 0 11 11 11 11 11 11 11 0 11 11 11 0 11 0 0 0 0 0 0 11 0 11 0 11 10 10 10 11 0 11 0 0 11 11 11 11 11 11 0 11 10 10 10 10 10 10 10 
10 10 10 10 10 10 10 10 10 10 10 10 10 10 10 10 10 10 10 10 10 10 10 10 10 10 10 10 10 10 10 10 11 11 0 0 0 0 0 11 11 10 10 10 10 10 10 10 11 0 0 0 0 0 0 0 0 0 0 0 0 0 0 11 0 11 0 11 11 11 11 11 11 0 11 0 11 11 11 11 11 0 11 0 0 11 9 0 0 0 11 0 11 10 10 10 10 10 10 10 
10 10 10 10 10 10 10 10 10 10 10 10 10 10 10 10 10 10 10 10 10 10 10 10 10 10 10 10 10 10 10 10 11 0 1 2 2 2 3 0 11 10 10 10 10 10 10 10 11 0 0 0 0 11 11 11 11 11 11 11 0 11 0 11 0 11 0 11 10 10 11 9 11 0 11 0 11 0 0 0 0 0 0 0 0 11 11 11 11 0 11 0 11 10 10 10 10 10 10 10 
10 10 10 10 10 10 10 10 10 10 10 10 10 10 10 10 10 10 10 10 10 10 10 10 10 10 10 10 10 10 10 10 11 0 8 9 9 9 4 0 11 10 10 10 10 10 10 10 11 0 0 0 11 11 10 10 10 10 10 11 0 11 0 11 0 11 0 11 10 10 11 0 11 0 11 0 11 11 11 11 11 0 11 0 0 0 0 0 0 0 11 9 11 10 10 10 10 10 10 10 
10 10 10 10 10 10 10 10 10 10 10 10 10 10 10 10 10 10 10 10 10 10 10 10 10 10 10 10 10 10 10 10 11 0 8 9 9 9 4 0 11 10 10 10 10 10 10 10 11 0 0 0 11 10 10 10 10 10 10 11 0 11 0 11 0 11 0 11 11 10 11 0 11 0 11 0 0 0 0 0 0 0 11 0 11 11 11 11 11 11 11 11 11 10 10 10 10 10 10 10 
10 10 10 10 10 10 10 10 10 10 10 10 10 10 10 10 10 10 10 10 10 10 10 10 10 10 10 10 10 10 10 10 11 0 8 9 9 9 4 0 11 10 10 10 10 10 10 10 11 0 0 0 11 11 10 10 10 10 10 11 0 11 0 11 0 11 0 9 11 11 11 0 11 0 11 0 11 11 11 11 11 0 11 0 11 0 0 0 11 1 2 3 11 10 10 10 10 10 10 10 
10 10 10 10 10 10 10 10 10 10 10 10 10 10 10 10 10 10 10 10 10 10 10 10 10 10 10 10 10 10 10 10 11 0 7 6 6 6 5 0 11 10 10 10 10 10 10 10 11 0 0 0 0 11 11 11 11 11 11 11 11 11 11 11 0 11 11 11 11 0 0 0 11 0 11 0 11 10 10 10 11 0 11 0 0 0 11 0 0 7 6 5 11 10 10 10 10 10 10 10 
10 10 10 10 10 10 10 10 10 10 10 10 10 10 10 10 10 10 10 10 10 10 10 10 10 10 10 10 10 10 10 10 11 11 0 0 0 0 0 11 11 10 10 10 10 10 10 10 11 0 0 0 0 0 0 0 0 0 0 0 0 0 0 0 0 0 0 0 0 0 11 11 11 0 11 0 11 11 11 11 11 0 11 0 11 11 11 11 11 11 11 11 11 10 10 10 10 10 10 10 
10 10 10 10 10 10 10 10 10 10 10 10 10 10 10 10 10 10 10 10 10 10 10 10 10 10 10 10 10 10 10 10 10 11 11 11 11 11 11 11 10 10 10 10 10 10 10 10 11 0 0 0 0 11 11 11 11 11 11 11 0 11 11 11 11 11 11 11 11 0 11 0 11 0 11 0 11 10 11 0 0 0 0 0 11 0 0 0 0 0 0 0 11 10 10 10 10 10 10 10 
10 10 10 10 10 10 10 10 10 10 10 10 10 10 10 10 10 10 10 10 10 10 10 10 10 10 10 10 10 10 10 10 10 10 10 10 10 10 10 10 10 10 10 10 10 10 10 10 11 0 0 0 11 11 10 10 10 10 10 11 0 0 0 0 0 0 0 0 0 0 11 0 11 0 11 0 11 11 11 0 11 0 11 11 11 0 11 11 11 11 11 0 11 10 10 10 10 10 10 10 
10 10 10 10 10 10 10 10 10 10 10 10 10 10 10 10 10 10 10 10 10 10 10 10 10 10 10 10 10 10 10 10 10 10 10 10 10 10 10 10 10 10 10 10 10 10 10 10 11 0 0 0 11 10 10 10 10 10 10 11 11 11 11 11 11 0 11 11 11 11 11 0 11 0 11 0 11 0 0 0 0 0 0 0 11 0 11 0 0 0 11 0 11 10 10 10 10 10 10 10 
10 10 10 10 10 10 10 10 10 10 10 10 10 10 10 10 10 10 10 10 10 10 10 10 10 10 10 10 10 10 10 10 10 10 10 10 10 10 10 10 10 10 10 10 10 10 10 11 11 11 0 11 11 11 10 10 10 10 10 11 9 0 0 0 0 0 0 0 0 0 0 0 11 9 11 0 0 0 0 0 11 0 11 0 11 0 11 0 11 11 11 0 11 10 10 10 10 10 10 10 
10 10 10 10 10 10 10 10 10 10 10 10 10 10 10 10 10 10 10 10 10 10 10 10 10 10 10 10 10 10 10 10 10 10 10 10 10 10 10 10 10 10 10 10 10 10 11 11 0 0 0 0 0 11 11 10 10 10 10 11 11 11 11 11 11 11 11 11 11 11 11 0 11 11 11 0 11 11 11 0 0 0 11 9 11 0 0 0 0 0 0 0 11 10 10 10 10 10 10 10 
10 10 10 10 10 10 10 10 10 10 10 10 10 10 10 10 10 10 10 10 10 10 10 10 10 10 10 10 10 10 10 10 10 10 10 10 10 10 10 10 10 10 10 10 10 10 11 0 1 2 2 2 3 0 11 10 10 10 10 11 0 0 0 0 0 0 0 0 0 0 0 0 0 0 0 0 11 9 11 0 11 11 11 11 11 0 11 0 11 11 11 11 11 10 10 10 10 10 10 10 
10 10 10 10 10 10 10 10 10 10 10 10 10 10 10 10 10 10 10 10 10 10 10 10 10 10 10 10 10 10 10 10 10 10 10 10 10 10 10 10 10 10 10 10 10 10 11 0 8 9 9 9 4 0 11 10 10 10 10 11 0 11 11 11 11 11 11 11 11 11 11 11 11 11 11 0 11 0 11 0 11 0 0 0 0 0 11 0 11 10 11 9 11 10 10 10 10 10 10 10 
10 10 10 10 10 10 10 10 10 10 10 10 10 10 10 10 10 10 10 10 10 10 10 10 10 10 10 10 10 10 10 10 10 10 10 10 10 10 10 10 10 10 10 10 10 10 11 0 8 9 9 9 4 0 11 10 10 10 10 11 0 11 0 0 0 0 0 0 0 0 0 0 0 0 0 0 11 0 11 0 11 11 11 11 11 0 11 0 11 10 11 0 11 10 10 10 10 10 10 10 
10 10 10 10 10 10 10 10 10 10 10 10 10 10 10 10 10 10 10 10 10 10 10 10 10 10 10 10 10 10 10 10 10 10 10 10 10 10 10 10 10 10 10 10 10 10 11 0 8 9 9 9 4 0 11 10 10 10 10 11 0 11 0 11 11 11 11 11 11 0 11 11 11 11 11 0 11 0 11 0 11 0 0 0 0 0 11 0 11 10 11 0 11 10 10 10 10 10 10 10 
10 10 10 10 10 10 10 10 10 10 10 10 10 10 10 10 10 10 10 10 10 10 10 10 10 10 10 10 10 10 10 10 10 10 10 10 10 10 10 10 10 10 10 10 10 10 11 0 7 6 6 6 5 0 11 10 10 10 10 11 0 11 0 11 9 0 11 10 11 0 0 0 0 9 11 0 11 0 11 0 11 0 11 11 11 11 11 0 11 10 11 0 11 10 10 10 10 10 10 10 
10 10 10 10 10 10 10 10 10 10 10 10 10 10 10 10 10 10 10 10 10 10 10 10 10 10 10 10 10 10 10 10 10 10 10 10 10 10 10 10 10 10 10 10 10 10 11 11 0 0 0 0 0 11 11 10 10 10 10 11 0 11 0 11 11 0 11 11 11 11 11 11 11 11 11 0 11 0 11 0 11 0 0 0 11 9 11 0 11 11 11 0 11 10 10 10 10 10 10 10 
10 10 10 10 10 10 10 10 10 10 10 10 10 10 10 10 10 11 11 11 11 11 11 11 11 11 10 10 10 10 10 10 10 10 10 10 10 10 10 10 10 10 10 10 10 10 10 11 11 11 11 11 11 11 10 10 10 10 10 11 9 11 0 0 0 0 0 0 0 0 0 0 0 0 11 0 11 0 0 0 0 0 11 0 0 0 11 0 0 0 0 0 11 10 10 10 10 10 10 10 
10 10 10 10 10 10 10 10 10 10 10 10 10 11 11 11 11 11 0 0 1 2 3 0 0 11 11 11 11 11 10 10 10 10 10 10 10 10 10 10 10 10 10 10 10 10 10 10 10 10 10 10 10 10 10 10 10 10 11 11 11 11 11 11 11 11 11 11 11 11 11 11 11 11 11 11 11 11 11 11 11 11 11 11 11 11 11 11 11 11 11 11 11 11 10 10 10 10 10 10 
10 10 10 10 10 10 10 10 10 10 10 11 11 11 1 2 3 0 0 0 8 9 4 0 0 0 1 2 3 11 11 11 10 10 10 10 10 10 10 10 10 10 10 10 10 10 10 10 10 10 10 10 10 10 10 10 10 10 11 11 10 10 10 10 10 10 10 10 10 10 10 10 10 10 10 10 10 10 10 10 10 10 10 10 10 10 10 10 10 10 10 10 11 11 10 10 10 10 10 10 
10 10 10 10 10 10 10 10 10 10 11 11 0 0 8 9 4 0 0 0 7 6 5 0 0 0 8 9 4 0 0 11 11 10 10 10 10 10 10 10 10 10 10 10 10 10 10 10 10 10 10 10 10 10 10 10 10 10 10 10 10 10 10 10 10 10 10 10 10 10 10 10 10 10 10 10 10 10 10 10 10 10 10 10 10 10 10 10 10 10 10 10 10 10 10 10 10 10 10 10 
10 10 10 10 10 10 10 10 10 11 11 0 0 0 7 6 5 11 0 0 11 11 11 0 0 11 7 6 5 0 0 0 11 11 10 10 10 10 10 10 10 10 10 10 10 10 10 10 10 10 10 10 10 10 10 10 10 10 10 10 10 10 10 10 10 10 10 10 10 10 10 10 10 10 10 10 10 10 10 10 10 10 10 10 10 10 10 10 10 10 10 10 10 10 10 10 10 10 10 10 
10 10 10 10 10 10 10 10 11 11 0 0 0 0 0 0 11 11 0 0 0 0 0 0 0 11 11 0 0 0 0 0 0 11 11 10 10 10 10 10 10 10 10 10 10 10 10 10 10 10 10 10 10 10 10 10 10 10 10 10 10 10 10 10 10 10 10 10 10 10 10 10 10 10 10 10 10 10 10 10 10 10 10 10 10 10 10 10 10 10 10 10 10 10 10 10 10 10 10 10 
10 10 10 10 10 10 10 10 11 0 0 0 0 0 0 0 0 0 0 0 1 2 3 0 0 0 0 0 0 0 0 0 0 0 11 10 10 10 10 10 10 10 10 10 10 10 10 10 10 10 10 10 10 10 10 10 10 10 10 10 10 10 10 10 10 10 10 10 10 10 10 10 10 10 10 10 10 10 10 10 10 10 10 10 10 10 10 10 10 10 10 10 10 10 10 10 10 10 10 10 
10 10 10 10 10 10 10 10 11 0 0 0 0 0 11 11 11 0 0 0 8 9 4 0 0 0 11 11 11 0 0 0 0 0 11 10 10 10 10 10 10 10 10 10 10 10 10 10 10 10 10 10 10 10 10 10 10 10 10 10 10 10 10 10 10 10 10 10 10 10 10 10 10 10 10 10 10 10 10 10 10 10 10 10 10 10 10 10 10 10 10 10 10 10 10 10 10 10 10 10 
10 10 10 10 10 10 10 10 11 0 0 0 0 0 0 0 11 0 0 0 7 6 5 0 0 0 11 0 0 0 0 0 0 0 11 11 10 10 10 10 10 10 10 10 10 10 10 10 10 10 10 10 10 10 10 10 10 10 10 10 10 10 10 10 10 10 10 10 10 10 10 10 10 10 10 10 10 10 10 10 10 10 10 10 10 10 10 10 10 10 10 10 10 10 10 10 10 10 10 10 
10 10 10 10 10 10 10 11 11 0 0 0 1 2 3 0 11 0 0 0 0 0 0 0 0 0 11 0 1 2 3 0 0 0 0 11 10 10 10 10 10 10 10 10 10 10 10 10 10 10 10 10 10 10 10 10 10 10 10 10 10 10 10 10 10 10 10 10 10 10 10 10 10 10 10 10 10 10 10 10 10 10 10 10 10 10 10 10 10 10 10 10 10 10 10 10 10 10 10 10 
10 10 10 10 10 10 10 11 0 0 0 0 8 9 4 0 0 0 0 11 11 11 11 11 0 0 0 0 8 9 4 0 0 0 0 11 10 10 10 10 10 10 10 10 10 10 10 10 10 10 10 10 10 10 10 10 10 10 10 10 10 10 10 10 10 10 10 10 10 10 10 10 10 10 10 10 10 10 10 10 10 10 10 10 10 10 10 10 10 10 10 10 10 10 10 10 10 10 10 10 
10 10 10 10 10 10 10 11 0 0 0 0 7 6 5 0 0 0 0 0 1 2 3 0 0 0 0 0 7 6 5 0 0 0 0 11 10 10 10 10 10 10 10 10 10 10 10 10 10 10 10 10 10 10 10 10 10 10 10 10 10 10 10 10 10 10 10 10 10 10 10 10 10 10 10 10 10 10 10 10 10 10 10 10 10 10 10 10 10 10 10 10 10 10 10 10 10 10 10 10 
10 10 10 10 10 10 10 11 0 0 0 0 0 0 0 0 0 0 0 0 8 9 4 0 0 0 0 0 0 0 0 0 0 0 0 11 10 10 10 10 10 10 10 10 10 10 10 10 10 10 10 10 10 10 10 10 10 10 10 10 10 10 10 10 10 10 10 10 10 10 10 10 10 10 10 10 10 10 10 10 10 10 10 10 10 10 10 10 10 10 10 10 10 10 10 10 10 10 10 10 
10 10 10 10 10 10 10 11 11 11 11 0 0 0 0 0 0 0 0 0 7 6 5 0 0 0 0 0 0 0 0 0 11 11 11 11 10 10 10 10 10 10 10 10 10 10 10 10 10 10 10 10 10 10 10 10 10 10 10 10 10 10 10 10 10 10 10 10 10 10 10 10 10 10 10 10 10 10 10 10 10 10 10 10 10 10 10 10 10 10 10 10 10 10 10 10 10 10 10 10 
10 10 10 10 10 10 10 10 10 10 11 11 11 11 11 11 11 11 11 11 11 11 11 11 11 11 11 11 11 11 11 11 11 10 10 10 10 10 10 10 10 10 10 10 10 10 10 10 10 10 10 10 10 10 10 10 10 10 10 10 10 10 10 10 10 10 10 10 10 10 10 10 10 10 10 10 10 10 10 10 10 10 10 10 10 10 10 10 10 10 10 10 10 10 10 10 10 10 10 10 
10 10 10 10 10 10 10 10 10 10 10 10 10 10 10 10 10 10 10 10 10 10 10 10 10 10 10 10 10 10 10 10 10 10 10 10 10 10 10 10 10 10 10 10 10 10 10 10 10 10 10 10 10 10 10 10 10 10 10 10 10 10 10 10 10 10 10 10 10 10 10 10 10 10 10 10 10 10 10 10 10 10 10 10 10 10 10 10 10 10 10 10 10 10 10 10 10 10 10 10 
10 10 10 10 10 10 10 10 10 10 10 10 10 10 10 10 10 10 10 10 10 10 10 10 10 10 10 10 10 10 10 10 10 10 10 10 10 10 10 10 10 10 10 10 10 10 10 10 10 10 10 10 10 10 10 10 10 10 10 10 10 10 10 10 10 10 10 10 10 10 10 10 10 10 10 10 10 10 10 10 10 10 10 10 10 10 10 10 10 10 10 10 10 10 10 10 10 10 10 10 
10 10 10 10 10 10 10 10 10 10 10 10 10 10 10 10 10 10 10 10 10 10 10 10 10 10 10 10 10 10 10 10 10 10 10 10 10 10 10 10 10 10 10 10 10 10 10 10 10 10 10 10 10 10 10 10 10 10 10 10 10 10 10 10 10 10 10 10 10 10 10 10 10 10 10 10 10 10 10 10 10 10 10 10 10 10 10 10 10 10 10 10 10 10 10 10 10 10 10 10 
10 10 10 10 10 10 10 10 10 10 10 10 10 10 10 10 10 10 10 10 10 10 10 10 10 10 10 10 10 10 10 10 10 10 10 10 10 10 10 10 10 10 10 10 10 10 10 10 10 10 10 10 10 10 10 10 10 10 10 10 10 10 10 10 10 10 10 10 10 10 10 10 10 10 10 10 10 10 10 10 10 10 10 10 10 10 10 10 10 10 10 10 10 10 10 10 10 10 10 10 
10 10 10 10 10 10 10 10 10 10 10 10 10 10 10 10 10 10 10 10 10 10 10 10 10 10 10 10 10 10 10 10 10 10 10 10 10 10 10 10 10 10 10 10 10 10 10 10 10 10 10 10 10 10 10 10 10 10 10 10 10 10 10 10 10 10 10 10 10 10 10 10 10 10 10 10 10 10 10 10 10 10 10 10 10 10 10 10 10 10 10 10 10 10 10 10 10 10 10 10 
10 10 10 10 10 10 10 10 10 10 10 10 10 10 10 10 10 10 10 10 10 10 10 10 10 10 10 10 10 10 10 10 10 10 10 10 10 10 10 10 10 10 10 10 10 10 10 10 10 10 10 10 10 10 10 10 10 10 10 10 10 10 10 10 10 10 10 10 10 10 10 10 10 10 10 10 10 10 10 10 10 10 10 10 10 10 10 10 10 10 10 10 10 10 10 10 10 10 10 10 
