10 10 10 10 10 10 10 10 10 10 10 10 10 10 10 10 10 10 10 10 10 10 10 10 10 10 10 10 10 10 10 10 10 10 10 10 10 10 10 10 10 10 10 10 10 10 10 10 10 10 10 10 10 10 10 10 10 10 10 10 10 10 10 10 10 10 10 10 10 10 10 10 10 10 10 10 10 10 10 10 10 10 10 10 10 10 10 10 10 10 10 10 10 10 10 10 10 10 10 10 
10 10 10 10 10 10 10 10 10 10 10 10 10 10 10 10 10 10 10 10 10 10 10 10 10 10 10 10 10 10 10 10 10 10 10 10 10 10 10 10 10 10 10 10 10 10 10 10 10 10 10 10 10 10 10 10 10 10 10 10 10 10 10 10 10 10 10 10 10 10 10 10 10 10 10 10 10 10 10 10 10 10 10 10 10 10 10 10 10 10 10 10 10 10 10 10 10 10 10 10 
10 10 10 10 10 10 10 10 10 10 10 10 10 10 10 10 10 10 10 10 10 10 10 10 10 10 10 10 10 10 10 10 10 10 10 10 10 10 10 10 10 10 10 10 10 10 10 10 10 10 10 10 10 10 10 10 10 10 10 10 10 10 10 10 10 10 10 10 10 10 10 10 10 10 10 10 10 10 10 10 10 10 10 10 10 10 10 10 10 10 10 10 10 10 10 10 10 10 10 10 
10 10 10 10 10 10 10 10 10 10 10 10 10 10 10 10 10 10 10 10 10 10 10 10 10 10 10 10 10 10 10 10 10 10 10 10 10 10 10 10 10 10 10 10 10 10 10 10 10 10 10 10 10 10 10 10 10 10 10 10 10 10 10 10 10 10 10 10 10 10 10 10 10 10 10 10 10 10 10 10 10 10 10 10 10 10 10 10 10 10 10 10 10 10 10 10 10 10 10 10 
10 10 10 10 10 10 10 10 10 10 10 10 10 10 10 10 10 10 10 10 10 10 10 10 10 10 10 10 10 10 10 10 10 10 10 10 10 10 10 10 10 10 10 10 10 10 10 10 10 10 10 10 10 10 10 10 10 10 10 10 10 10 10 10 10 10 10 10 10 10 10 10 10 10 10 10 10 10 10 10 10 10 10 10 10 10 10 10 10 10 10 10 10 10 10 10 10 10 10 10 
10 10 10 10 10 10 10 10 10 10 10 10 10 10 10 10 10 10 10 10 10 10 10 10 10 10 10 10 10 10 10 10 10 10 10 10 10 10 10 10 10 10 10 10 10 10 10 10 10 10 10 10 10 10 10 10 10 10 10 10 10 10 10 10 10 10 10 10 10 10 10 10 10 10 10 10 10 10 10 10 10 10 10 10 10 10 10 10 10 10 10 10 10 10 10 10 10 10 10 10 
10 10 10 10 10 10 10 10 10 10 10 10 10 10 10 10 10 10 10 10 10 10 10 10 10 10 10 10 10 10 10 10 10 10 10 10 10 10 10 10 10 10 10 10 10 10 10 10 10 10 10 10 10 10 10 10 17 12 12 12 12 12 12 12 12 12 12 12 12 12 12 12 12 12 12 12 12 12 12 12 12 12 12 12 12 12 12 12 12 12 12 12 19 10 10 10 10 10 10 10 
10 10 10 10 10 10 10 10 10 10 10 10 10 10 10 17 12 12 12 12 12 12 12 12 19 10 10 10 10 10 10 10 10 10 10 10 10 10 10 10 10 10 10 10 10 10 10 10 10 10 10 10 10 10 10 17 21 11 24 11 11 11 11 11 11 24 24 11 11 11 24 24 24 11 11 11 11 11 11 24 11 11 11 11 11 11 11 24 24 11 11 24 20 19 10 10 10 10 10 10 
10 10 10 10 10 10 10 10 10 10 10 10 10 10 17 21 24 24 11 11 11 11 11 24 20 19 10 10 10 10 10 10 10 10 10 10 10 10 10 10 10 10 10 10 10 10 10 10 10 10 10 10 10 10 10 15 24 11 0 11 24 24 11 0 1 3 11 11 0 0 0 0 0 11 24 24 11 0 0 0 0 0 24 11 0 0 0 0 0 0 0 11 24 14 10 10 10 10 10 10 
10 10 10 10 10 10 10 10 10 10 10 10 17 12 21 11 11 0 0 1 3 0 0 11 11 20 12 19 10 10 10 10 10 10 10 10 10 10 10 10 10 10 10 10 10 10 10 10 10 10 10 10 10 10 10 15 24 0 0 0 11 11 0 0 7 5 0 0 0 11 11 0 0 0 11 11 0 0 11 11 0 0 0 0 0 0 0 0 1 2 3 0 11 14 10 10 10 10 10 10 
10 10 10 10 10 10 10 10 10 10 10 17 21 11 11 11 0 0 11 7 5 11 0 0 11 11 11 20 19 10 10 10 10 10 10 10 10 10 10 10 10 10 10 10 10 10 10 10 10 10 10 10 10 10 10 15 11 0 0 0 0 0 0 0 11 11 0 0 11 23 22 11 0 0 0 0 0 24 23 22 11 0 0 0 11 11 0 0 8 9 4 0 11 14 10 10 10 10 10 10 
10 10 10 10 10 10 10 10 10 10 17 21 11 11 0 0 0 0 11 11 24 24 0 0 0 0 11 24 20 19 10 10 10 10 10 10 10 10 10 10 10 10 10 10 10 10 10 10 10 10 10 10 10 10 10 15 11 11 11 0 0 0 0 11 23 22 11 0 11 20 21 11 0 0 0 0 0 11 20 21 24 0 0 11 23 22 24 0 7 6 5 0 11 14 10 10 10 10 10 10 
10 10 10 10 10 10 10 10 10 17 21 11 24 0 0 1 2 2 2 2 2 2 2 2 3 0 0 11 11 20 19 10 10 10 10 10 10 10 10 10 10 10 10 10 10 10 10 10 10 10 10 10 10 10 10 15 11 23 22 24 0 0 0 11 20 21 24 0 0 11 11 0 0 0 0 0 0 0 11 11 0 0 0 11 20 21 24 0 0 0 0 0 11 14 10 10 10 10 10 10 
10 10 10 10 10 10 10 10 17 21 11 11 0 0 0 8 9 9 9 9 9 9 9 9 4 0 0 0 11 24 20 19 10 10 10 10 10 10 10 10 10 10 10 10 10 10 10 10 10 10 10 10 10 10 10 15 11 20 21 11 0 0 0 0 11 11 0 0 0 0 0 0 0 0 11 11 0 0 0 0 0 0 0 0 11 11 0 0 0 0 0 11 24 14 10 10 10 10 10 10 
10 10 10 10 10 10 10 10 15 24 11 0 0 0 0 8 9 9 9 9 9 9 9 9 4 0 0 0 0 24 11 14 10 10 10 10 10 10 10 10 10 10 10 10 10 10 10 10 10 10 10 10 10 10 10 15 11 11 24 0 0 0 0 0 0 0 0 0 11 11 0 0 0 11 23 22 24 0 0 0 0 0 0 0 0 0 0 11 11 0 0 11 11 14 10 10 10 10 10 10 
10 10 10 10 10 10 10 10 15 24 0 0 11 11 0 8 9 9 9 9 9 9 9 9 4 0 24 11 0 0 11 14 10 10 10 10 10 10 10 10 10 10 10 10 10 10 10 10 10 10 10 10 10 10 10 15 11 0 0 0 0 0 11 11 0 0 0 24 23 22 11 0 0 11 20 21 11 0 0 0 11 11 0 0 0 0 11 23 22 11 0 0 11 14 10 10 10 10 10 10 
10 10 10 10 10 10 10 10 15 11 1 3 11 0 0 8 9 9 9 9 9 9 9 9 4 0 0 11 0 0 11 14 10 10 10 10 10 10 10 10 10 10 10 10 10 10 10 10 10 10 10 10 10 10 10 15 24 11 11 0 0 11 23 22 11 0 0 11 20 21 11 0 0 0 11 11 0 0 0 11 23 22 11 0 0 0 24 20 21 11 0 0 11 14 10 10 10 10 10 10 
10 10 10 10 10 10 10 10 15 11 7 5 24 0 0 8 9 9 9 9 9 9 9 9 4 0 0 11 0 0 24 14 10 10 10 10 10 10 10 10 10 10 10 10 10 10 10 10 10 10 10 10 10 10 10 15 24 23 22 11 0 11 20 21 11 0 0 0 11 11 0 0 0 0 0 0 0 0 0 11 20 21 11 0 0 0 0 11 11 0 0 11 24 14 10 10 10 10 10 10 
10 10 10 10 10 10 10 10 15 11 0 0 24 11 0 8 9 9 9 9 9 9 9 9 4 0 11 11 0 0 11 14 10 10 10 10 10 10 10 10 10 10 10 10 10 10 10 10 10 10 10 10 10 10 10 15 24 20 21 24 0 0 11 11 0 0 0 0 0 0 0 0 11 24 0 0 0 0 0 0 24 11 0 0 11 11 0 0 0 0 11 24 11 14 10 10 10 10 10 10 
10 10 10 10 10 10 10 10 15 11 24 0 0 0 0 8 9 9 9 9 9 9 9 9 4 0 0 0 0 11 11 14 10 10 10 10 10 10 10 10 10 10 10 10 10 10 10 10 10 10 10 10 10 10 10 15 11 11 11 0 0 0 0 0 0 0 0 0 0 0 0 11 23 22 11 0 0 24 11 0 0 0 0 11 23 22 11 0 0 0 24 24 11 14 10 10 10 10 10 10 
10 10 10 10 10 10 10 10 16 22 24 0 0 0 0 7 6 6 6 6 6 6 6 6 5 0 0 0 0 24 23 18 10 10 10 10 10 10 10 10 10 10 10 10 10 10 10 10 10 10 10 10 10 10 10 15 11 0 1 2 3 0 0 24 11 0 0 0 0 0 0 11 20 21 11 0 11 23 22 11 0 0 0 11 20 21 11 0 0 1 3 11 11 14 10 10 10 10 10 10 
10 10 10 10 10 10 10 10 10 15 11 11 0 0 0 0 0 24 0 0 0 0 11 0 0 0 0 0 11 11 14 10 10 10 10 10 10 10 10 10 10 10 10 10 10 10 10 10 10 10 10 10 10 10 10 15 24 0 8 9 4 0 11 23 22 11 0 0 11 11 0 0 24 11 0 0 11 20 21 11 0 0 0 0 11 11 0 0 0 7 5 0 24 14 10 10 10 10 10 10 
10 10 10 10 10 10 10 10 10 16 22 11 11 11 0 0 0 11 11 11 24 11 11 0 0 0 24 11 11 23 18 10 10 10 10 10 10 10 10 10 10 10 10 10 10 10 10 10 10 10 10 10 10 10 10 15 11 11 7 6 5 0 11 20 21 11 0 11 24 24 11 0 0 0 0 0 0 11 11 0 0 0 0 0 0 0 0 0 11 11 0 11 11 14 10 10 10 10 10 10 
10 10 10 10 10 10 10 10 10 10 16 13 22 24 24 11 0 0 0 0 0 0 0 0 11 11 11 23 13 18 10 10 10 10 10 10 10 10 10 10 10 10 10 10 10 10 10 10 10 10 10 10 10 10 10 16 22 11 11 11 11 24 24 11 11 11 11 11 11 11 24 11 11 11 11 11 11 24 11 11 11 11 24 24 24 24 11 11 11 11 11 24 23 18 10 10 10 10 10 10 
10 10 10 10 10 10 10 10 10 10 10 10 16 13 22 11 11 24 0 1 3 0 24 11 11 23 13 18 10 10 10 10 10 10 10 10 10 10 10 10 10 10 10 10 10 10 10 10 10 10 10 10 10 10 10 10 16 13 13 13 13 13 13 13 13 13 13 13 13 13 13 13 13 13 13 13 13 13 13 13 13 13 13 13 13 13 13 13 13 13 13 13 18 10 10 10 10 10 10 10 
10 10 10 10 10 10 10 10 10 10 10 10 10 10 16 13 22 11 0 8 4 0 11 23 13 18 10 10 10 10 10 10 10 10 10 10 10 10 10 10 10 10 10 10 10 10 10 10 10 10 10 10 10 10 10 10 10 10 10 10 10 10 10 10 10 10 10 10 10 10 10 10 10 10 10 10 10 10 10 10 10 10 10 10 10 10 10 10 10 10 10 10 10 10 10 10 10 10 10 10 
10 10 10 10 10 10 10 10 10 10 10 10 10 10 10 10 15 11 0 8 4 0 11 14 10 10 10 10 10 10 10 10 10 10 10 10 10 10 10 10 10 10 10 10 10 10 10 10 10 10 10 10 10 10 10 10 10 10 10 10 10 10 10 10 10 10 10 10 10 10 10 10 10 10 10 10 10 10 10 10 10 10 10 10 10 10 10 10 10 10 10 10 10 10 10 10 10 10 10 10 
10 10 10 10 10 10 10 10 10 10 10 10 10 10 10 10 15 11 0 8 4 0 11 14 10 10 10 10 10 10 10 10 10 10 10 10 10 10 10 10 10 10 10 10 10 10 10 10 10 10 10 10 10 10 10 10 10 10 10 10 10 10 10 10 10 10 10 10 10 10 10 10 10 10 10 10 10 10 10 10 10 10 10 10 10 10 10 10 10 10 10 10 10 10 10 10 10 10 10 10 
10 10 10 10 10 10 10 10 10 10 10 10 10 10 10 10 15 11 0 8 4 0 24 14 10 10 10 10 10 10 10 10 10 10 10 10 10 10 10 10 10 17 12 12 12 12 12 12 12 12 12 12 19 10 10 10 10 10 10 10 10 10 10 10 10 10 10 10 10 10 10 10 10 10 10 10 10 10 10 10 10 10 10 10 10 10 10 10 10 10 10 10 10 10 10 10 10 10 10 10 
10 10 10 10 10 10 10 10 10 10 10 10 10 10 10 10 15 11 0 8 4 0 24 14 10 10 10 10 10 10 10 10 10 10 10 10 10 10 10 10 10 15 11 11 11 24 11 11 11 11 11 11 14 10 10 10 10 10 10 10 10 10 10 10 10 10 10 10 10 10 10 10 10 10 10 10 10 10 10 10 10 10 10 10 10 10 10 10 10 10 10 10 10 10 10 10 10 10 10 10 
10 10 10 10 10 10 10 10 10 10 10 10 10 10 10 10 15 24 0 8 4 0 11 14 10 10 10 10 10 10 10 10 10 17 12 12 12 12 12 12 12 21 24 0 0 0 0 0 0 0 0 24 14 10 10 10 10 10 10 10 10 10 10 10 10 10 10 10 10 10 10 10 10 10 10 10 10 10 10 10 10 10 10 10 10 10 10 10 10 10 10 10 10 10 10 10 10 10 10 10 
10 10 10 10 10 10 10 10 10 10 10 10 10 10 10 10 15 11 0 7 5 0 11 14 10 10 10 10 10 10 10 10 10 15 11 11 24 11 11 11 24 11 11 0 1 2 2 2 2 3 0 11 14 10 10 10 10 10 10 10 10 10 10 10 10 10 10 10 10 10 10 10 10 10 10 10 10 10 10 10 10 10 10 10 10 10 10 10 10 10 10 10 10 10 10 10 10 10 10 10 
10 10 10 10 10 10 10 10 10 10 10 10 10 10 10 10 15 11 11 0 0 11 11 14 10 10 10 10 10 10 10 10 10 15 11 0 0 0 0 0 0 0 0 0 8 9 9 9 9 4 0 24 14 10 10 10 10 10 10 10 10 10 10 10 10 10 17 12 12 12 12 12 19 10 10 10 10 10 10 10 10 10 10 10 10 10 10 10 10 10 10 10 10 10 10 10 10 10 10 10 
10 10 10 10 10 10 10 10 10 10 10 10 10 10 10 10 16 22 11 11 24 11 23 18 10 10 10 10 10 10 10 10 10 15 11 0 11 11 11 11 11 11 11 0 7 6 6 6 6 5 0 11 14 10 10 10 10 10 10 10 10 10 10 10 10 17 21 11 11 11 11 11 20 19 10 10 10 10 10 10 10 10 10 10 10 10 10 10 10 10 10 10 10 10 10 10 10 10 10 10 
10 10 10 10 10 10 10 10 10 10 10 10 10 10 10 10 10 16 13 13 13 13 18 10 10 10 10 10 10 10 10 10 10 15 24 0 11 23 13 22 11 24 24 0 0 0 0 0 0 0 0 11 20 12 12 12 12 12 12 12 12 19 10 10 17 21 11 24 0 0 0 24 11 20 19 10 10 10 10 10 10 10 10 10 10 10 10 10 10 10 10 10 10 10 10 10 10 10 10 10 
10 10 10 10 10 10 10 10 10 10 10 10 10 10 10 10 10 10 10 10 10 10 10 10 10 10 10 10 10 10 10 10 10 15 24 0 11 14 10 15 11 11 24 24 24 11 11 11 11 24 24 11 11 24 11 11 11 11 24 24 11 14 10 10 15 11 11 0 1 2 3 0 11 24 14 10 10 10 10 10 10 10 10 10 10 10 10 10 10 10 10 10 10 10 10 10 10 10 10 10 
10 10 10 10 10 10 10 10 10 10 10 10 10 10 10 10 10 10 10 10 10 10 10 10 10 10 10 10 10 10 10 10 10 15 11 0 11 14 10 15 11 0 0 0 0 0 11 24 0 0 0 0 0 11 24 0 0 0 0 0 11 14 10 10 15 11 0 0 8 9 4 0 0 24 14 10 10 10 10 10 10 10 10 10 10 10 10 10 10 10 10 10 10 10 10 10 10 10 10 10 
10 10 10 10 10 10 10 10 10 10 10 10 10 10 10 10 10 10 10 10 10 10 10 10 10 10 10 10 10 10 10 10 10 15 11 0 24 14 10 15 24 0 1 2 3 0 11 11 0 1 2 3 0 11 11 0 1 2 3 0 11 14 10 10 15 11 11 0 7 6 5 0 11 11 14 10 10 10 10 10 10 10 10 10 10 10 10 10 10 10 10 10 10 10 10 10 10 10 10 10 
10 10 10 10 10 10 10 10 10 10 10 10 10 10 10 10 10 10 10 10 10 10 10 10 10 10 10 10 10 10 10 10 10 15 11 0 11 14 10 15 11 0 7 6 5 0 11 11 0 7 6 5 0 24 11 0 7 6 5 0 11 14 10 10 16 22 24 24 0 0 0 11 11 23 18 10 10 10 10 10 10 10 10 10 10 10 10 10 10 10 10 10 10 10 10 10 10 10 10 10 
10 10 10 10 10 10 10 10 10 10 10 10 10 10 10 10 10 10 10 10 10 10 10 10 10 10 10 10 10 10 10 10 10 15 24 0 11 14 10 15 11 0 0 0 0 0 11 24 0 0 0 0 0 24 24 0 0 0 0 0 11 14 10 10 10 16 22 11 11 0 11 24 23 18 10 10 10 10 10 10 10 10 10 10 10 10 10 10 10 10 10 10 10 10 10 10 10 10 10 10 
10 10 10 10 10 10 10 10 10 10 10 10 10 10 10 10 10 10 10 10 10 10 10 10 10 10 10 10 10 10 10 10 10 15 11 0 11 14 10 15 11 11 11 0 11 24 24 24 11 11 0 11 11 24 24 24 11 0 11 24 11 14 10 10 10 10 16 22 11 0 11 23 18 10 10 10 10 10 10 10 10 10 10 10 10 10 10 10 10 10 10 10 10 10 10 10 10 10 10 10 
10 10 10 10 10 10 10 10 10 10 10 10 10 10 10 10 10 10 10 10 10 10 10 10 10 10 10 10 10 10 10 10 10 15 11 0 24 14 10 16 22 11 0 0 0 11 23 22 11 0 0 0 11 23 22 11 0 0 0 11 23 18 10 10 10 10 10 15 11 0 24 14 10 10 10 10 10 10 10 10 10 10 10 10 10 10 10 10 10 10 10 10 10 10 10 10 10 10 10 10 
10 10 10 10 10 10 10 10 10 10 10 10 10 10 10 10 10 10 10 10 10 10 10 10 10 10 10 10 10 10 10 10 10 15 11 0 11 20 12 12 21 11 0 0 0 11 14 15 24 0 0 0 11 14 15 11 0 0 0 11 20 12 12 12 12 12 12 21 11 0 11 14 10 10 10 10 10 10 10 10 10 10 10 10 10 10 10 10 10 10 10 10 10 10 10 10 10 10 10 10 
10 10 10 10 10 10 10 10 10 10 10 10 10 10 10 10 10 10 10 10 10 10 10 10 10 10 10 10 10 10 10 10 10 15 24 0 11 11 11 24 11 11 0 0 0 11 14 15 11 0 0 0 11 14 15 11 0 0 0 11 11 11 24 24 11 11 11 11 11 0 11 14 10 10 10 10 10 10 10 10 10 10 10 10 10 10 17 12 12 12 12 12 12 19 10 10 10 10 10 10 
10 10 10 10 10 10 10 10 10 10 10 10 10 10 10 10 10 10 10 10 10 10 10 10 10 10 10 10 10 10 10 10 10 15 11 0 0 0 0 0 0 0 0 0 0 24 14 15 11 0 0 0 11 14 15 11 0 0 0 0 0 0 0 0 0 0 0 0 0 0 11 14 10 10 10 10 10 10 10 10 10 10 10 10 10 17 21 11 11 24 24 11 11 14 10 10 10 10 10 10 
10 10 10 10 10 10 10 10 10 10 10 10 10 10 10 10 10 10 10 10 10 10 10 10 10 10 10 10 10 10 10 10 10 15 11 11 11 24 11 11 24 24 0 0 0 24 14 15 11 0 0 0 11 14 15 11 0 0 0 11 11 11 11 11 11 11 24 11 11 11 11 14 10 10 10 17 12 12 12 12 12 12 12 12 12 21 11 11 0 0 0 0 11 14 10 10 10 10 10 10 
10 10 10 10 10 10 10 10 10 10 10 10 10 10 10 10 10 10 10 10 10 10 10 10 10 10 10 10 10 10 10 10 10 16 13 13 13 13 13 22 11 11 0 0 0 11 20 21 11 0 0 0 11 20 21 11 0 0 0 24 11 23 13 13 13 13 13 13 13 13 13 18 10 10 17 21 11 24 11 11 24 11 11 11 11 24 11 0 1 2 3 0 11 14 10 10 10 10 10 10 
10 10 10 10 10 10 10 10 10 10 10 10 10 10 10 10 10 10 10 17 12 12 12 12 12 19 10 10 10 10 10 10 10 17 12 12 12 12 12 21 24 11 0 0 0 11 11 24 24 0 0 0 11 24 11 11 0 0 0 24 24 20 12 12 12 12 12 12 12 12 12 12 12 12 21 24 24 0 0 0 0 0 0 0 0 0 0 0 8 9 4 0 24 14 10 10 10 10 10 10 
10 10 10 10 10 10 10 10 10 10 10 10 10 10 10 10 10 10 10 15 11 24 11 11 11 20 12 12 12 12 12 12 12 21 24 11 11 24 24 24 11 0 0 0 0 0 11 11 0 0 0 0 0 11 11 0 0 0 0 0 11 11 11 11 11 24 11 11 11 11 11 11 24 11 11 11 0 0 1 2 2 2 2 2 2 2 3 0 8 9 4 0 11 14 10 10 10 10 10 10 
10 10 10 10 10 10 10 10 10 10 10 10 10 10 10 10 10 10 10 15 11 1 2 3 11 11 11 11 24 24 11 11 11 11 11 0 0 0 0 0 0 0 0 0 0 0 0 0 0 1 2 3 0 0 0 0 0 0 0 0 0 0 0 0 0 0 0 0 0 0 0 0 0 0 0 11 0 0 8 9 9 9 9 9 9 9 4 0 8 9 4 0 11 14 10 10 10 10 10 10 
10 10 10 10 10 10 10 10 10 10 10 10 10 10 10 10 10 10 10 15 24 8 9 4 0 0 0 0 0 0 0 0 0 0 0 0 0 0 0 0 0 0 0 0 0 0 0 0 0 8 9 4 0 0 0 0 0 0 0 0 0 0 0 0 0 0 0 0 0 0 0 0 0 0 0 0 0 0 8 9 9 9 9 9 9 9 4 0 8 9 4 0 11 14 10 10 10 10 10 10 
10 10 10 10 10 10 10 10 10 10 10 10 10 10 10 10 10 10 10 15 11 7 6 5 11 11 11 11 11 11 11 24 11 11 24 0 0 0 0 0 0 0 0 0 0 0 0 0 0 7 6 5 0 0 0 0 0 0 0 0 0 0 0 0 0 0 0 0 0 0 0 0 0 0 0 11 0 0 8 9 9 9 9 9 9 9 4 0 8 9 4 0 11 14 10 10 10 10 10 10 
10 10 10 10 10 10 10 10 10 10 10 10 10 10 10 10 10 10 10 15 11 11 11 11 24 23 13 13 13 13 13 13 13 22 11 0 0 0 11 11 24 24 11 11 11 11 24 11 0 0 0 0 0 11 11 24 24 11 11 11 11 24 11 11 11 11 11 24 24 24 11 11 11 11 11 11 0 0 7 6 6 6 6 6 6 6 5 0 8 9 4 0 11 14 10 10 10 10 10 10 
10 10 10 10 10 10 10 10 10 10 10 10 10 10 10 10 10 10 10 16 13 13 13 13 13 18 10 10 10 10 10 10 10 15 11 0 0 0 11 23 13 13 13 13 13 13 22 11 11 0 0 0 11 11 23 22 24 9 11 23 13 13 13 13 13 13 13 13 13 13 13 13 13 13 22 24 24 0 0 0 0 0 0 0 0 0 0 0 8 9 4 0 24 14 10 10 10 10 10 10 
10 10 10 10 10 10 10 10 10 10 10 10 10 10 10 10 10 10 10 10 10 10 10 10 10 10 10 10 10 10 10 10 10 15 11 0 0 0 11 14 10 10 10 10 10 10 16 22 11 0 0 0 24 24 20 21 11 0 11 20 12 12 12 12 12 12 12 12 12 12 12 12 12 12 21 11 11 24 24 24 24 24 11 11 11 11 11 0 7 6 5 0 11 14 10 10 10 10 10 10 
10 10 10 10 10 10 10 10 10 10 10 10 10 10 10 10 10 10 10 10 10 10 10 10 10 10 10 10 10 10 10 10 10 15 24 0 0 0 24 14 10 10 10 10 10 10 10 15 11 0 0 0 11 11 24 11 11 0 11 11 24 11 11 24 24 24 11 11 11 11 24 11 11 11 11 24 24 24 24 11 11 24 24 24 24 24 24 11 0 0 0 0 11 14 10 10 10 10 10 10 
10 10 10 10 10 10 10 10 10 10 10 10 10 10 10 10 10 10 10 10 10 10 10 10 10 10 10 10 10 10 10 10 10 15 11 0 0 0 24 14 10 10 10 10 10 10 10 15 11 0 0 0 11 24 11 0 0 0 0 0 0 0 0 0 0 0 0 0 0 11 0 0 0 0 11 11 11 24 24 24 24 11 11 11 11 24 24 24 24 24 11 24 11 14 10 10 10 10 10 10 
10 10 10 10 10 10 10 10 10 10 10 10 10 10 10 10 10 10 10 10 10 10 10 10 10 10 10 10 10 10 10 10 10 15 11 0 0 0 11 14 10 10 10 10 10 10 10 15 24 0 0 0 11 11 24 11 11 24 11 11 0 11 24 24 24 24 11 11 0 11 0 24 11 0 0 0 0 0 0 0 0 0 0 0 11 24 24 24 11 24 11 24 11 14 10 10 10 10 10 10 
10 10 10 10 10 10 10 10 10 10 10 10 10 10 10 10 10 10 10 10 10 10 10 10 10 10 10 10 10 10 10 10 10 15 24 0 0 0 11 14 10 10 10 10 10 10 10 15 11 0 0 0 24 24 23 13 13 13 22 11 0 11 1 2 3 11 0 24 0 24 0 0 11 0 11 11 24 11 11 24 11 24 11 0 0 11 24 11 11 11 11 11 11 14 10 10 10 10 10 10 
10 10 10 10 10 10 10 10 10 10 10 10 10 10 10 10 10 10 10 10 10 10 10 10 10 10 10 10 10 10 10 10 17 21 11 0 0 0 11 20 19 10 10 10 10 10 10 15 11 0 0 0 11 24 20 12 12 12 21 11 0 11 7 6 5 11 0 11 0 11 11 0 24 0 11 9 11 23 13 22 11 9 11 24 0 0 0 0 0 0 0 0 24 14 10 10 10 10 10 10 
10 10 10 10 10 10 10 10 10 10 10 10 10 10 10 10 10 10 10 10 10 10 10 10 10 10 10 10 10 10 10 17 21 24 11 11 0 11 11 24 20 19 10 10 10 10 10 15 11 0 0 0 0 11 11 11 24 11 11 11 0 24 24 11 0 24 0 0 0 0 0 0 11 0 11 0 24 20 12 21 11 0 11 0 0 11 11 24 24 11 11 0 11 14 10 10 10 10 10 10 
10 10 10 10 10 10 10 10 10 10 10 10 10 10 10 10 10 10 10 10 10 10 10 10 10 10 10 10 10 10 10 15 11 11 0 0 0 0 0 11 11 14 10 10 10 10 10 15 11 0 0 0 0 0 0 0 0 0 0 0 0 0 0 11 0 11 0 11 11 11 24 11 11 0 24 0 11 11 24 11 11 0 11 0 0 11 9 0 0 0 24 0 11 14 10 10 10 10 10 10 
10 10 10 10 10 10 10 10 10 10 10 10 10 10 10 10 10 10 10 10 10 10 10 10 10 10 10 10 10 10 10 15 11 0 1 2 2 2 3 0 11 14 10 10 10 10 10 15 24 0 0 0 0 11 11 24 11 11 11 11 0 11 0 24 0 11 0 11 23 22 11 9 11 0 11 0 11 0 0 0 0 0 0 0 0 24 24 11 11 0 11 0 11 14 10 10 10 10 10 10 
10 10 10 10 10 10 10 10 10 10 10 10 10 10 10 10 10 10 10 10 10 10 10 10 10 10 10 10 10 10 10 15 24 0 8 9 9 9 4 0 24 14 10 10 10 10 10 15 11 0 0 0 11 11 23 13 13 13 22 11 0 11 0 11 0 11 0 11 20 21 11 0 11 0 11 0 11 24 11 11 11 0 24 0 0 0 0 0 0 0 11 9 11 14 10 10 10 10 10 10 
10 10 10 10 10 10 10 10 10 10 10 10 10 10 10 10 10 10 10 10 10 10 10 10 10 10 10 10 10 10 10 15 11 0 8 9 9 9 4 0 11 14 10 10 10 10 10 15 11 0 0 0 11 24 14 10 10 10 15 24 0 24 0 11 0 11 0 11 24 24 11 0 11 0 24 0 0 0 0 0 0 0 11 0 24 11 11 11 11 11 11 11 11 14 10 10 10 10 10 10 
10 10 10 10 10 10 10 10 10 10 10 10 10 10 10 10 10 10 10 10 10 10 10 10 10 10 10 10 10 10 10 15 11 0 8 9 9 9 4 0 11 14 10 10 10 10 10 15 11 0 0 0 24 24 20 12 12 12 21 11 0 24 0 11 0 11 0 9 11 11 0 0 11 0 11 0 24 11 11 24 24 0 11 0 24 0 0 0 11 1 2 3 11 14 10 10 10 10 10 10 
10 10 10 10 10 10 10 10 10 10 10 10 10 10 10 10 10 10 10 10 10 10 10 10 10 10 10 10 10 10 10 15 11 0 7 6 6 6 5 0 11 14 10 10 10 10 10 15 24 0 0 0 0 11 11 11 24 24 24 11 11 11 11 11 0 24 24 11 11 0 0 24 24 0 11 0 11 23 13 22 11 0 11 0 0 0 24 0 0 7 6 5 11 14 10 10 10 10 10 10 
10 10 10 10 10 10 10 10 10 10 10 10 10 10 10 10 10 10 10 10 10 10 10 10 10 10 10 10 10 10 10 15 11 24 0 0 0 0 0 11 11 14 10 10 10 10 10 15 11 0 0 0 0 0 0 0 0 0 0 0 0 0 0 0 0 0 0 0 0 0 24 24 24 0 24 0 11 14 10 15 11 0 11 0 11 11 24 24 11 11 11 11 11 14 10 10 10 10 10 10 
10 10 10 10 10 10 10 10 10 10 10 10 10 10 10 10 10 10 10 10 10 10 10 10 10 10 10 10 10 10 10 16 22 11 11 11 11 24 24 11 23 18 10 10 10 10 10 15 11 0 0 0 0 11 11 11 24 11 11 24 0 11 11 11 24 24 24 11 11 0 11 0 11 0 11 0 11 20 12 21 24 0 0 0 11 0 0 0 0 0 0 0 24 14 10 10 10 10 10 10 
10 10 10 10 10 10 10 10 10 10 10 10 10 10 10 10 10 10 10 10 10 10 10 10 10 10 10 10 10 10 10 10 16 13 13 13 13 13 13 13 18 10 10 10 10 10 10 15 24 0 0 0 11 11 23 13 13 13 22 11 0 0 0 0 0 0 0 0 0 0 11 0 11 0 11 0 24 24 11 11 11 0 11 11 11 0 11 24 24 11 11 0 11 14 10 10 10 10 10 10 
10 10 10 10 10 10 10 10 10 10 10 10 10 10 10 10 10 10 10 10 10 10 10 10 10 10 10 10 10 10 10 10 10 10 10 10 10 10 10 10 10 10 10 10 10 10 17 21 11 0 0 0 11 24 14 10 10 10 15 11 11 24 11 11 11 0 11 11 11 24 24 0 11 0 11 0 11 0 0 0 0 0 0 0 11 0 11 0 0 9 11 0 11 14 10 10 10 10 10 10 
10 10 10 10 10 10 10 10 10 10 10 10 10 10 10 10 10 10 10 10 10 10 10 10 10 10 10 10 10 10 10 10 10 10 10 10 10 10 10 10 10 10 10 10 10 17 21 11 24 24 0 11 11 24 20 19 10 10 15 11 9 0 0 0 0 0 0 0 0 0 0 0 11 9 24 0 0 0 0 0 11 0 11 0 11 0 11 0 11 11 11 0 11 14 10 10 10 10 10 10 
10 10 10 10 10 10 10 10 10 10 10 10 10 10 10 10 10 10 10 10 10 10 10 10 10 10 10 10 10 10 10 10 10 10 10 10 10 10 10 10 10 10 10 10 10 15 11 11 0 0 0 0 0 11 11 14 10 10 15 24 11 11 24 11 11 11 11 11 11 11 11 0 24 24 11 0 11 11 11 0 0 0 11 9 11 0 0 0 0 0 0 0 11 14 10 10 10 10 10 10 
10 10 10 10 10 10 10 10 10 10 10 10 10 10 10 10 10 10 10 10 10 10 10 10 10 10 10 10 10 10 10 10 10 10 10 10 10 10 10 10 10 10 10 10 10 15 11 0 1 2 2 2 3 0 11 14 10 10 15 11 0 0 0 0 0 0 0 0 0 0 0 0 0 0 0 0 11 9 24 0 11 11 24 11 11 0 24 0 11 11 11 24 11 14 10 10 10 10 10 10 
10 10 10 10 10 10 10 10 10 10 10 10 10 10 10 10 10 10 10 10 10 10 10 10 10 10 10 10 10 10 10 10 10 10 10 10 10 10 10 10 10 10 10 10 10 15 24 0 8 9 9 9 4 0 11 14 10 10 15 11 0 24 11 11 11 11 24 11 11 11 11 24 11 11 11 0 11 0 11 0 11 0 0 0 0 0 11 0 11 10 11 9 11 14 10 10 10 10 10 10 
10 10 10 10 10 10 10 10 10 10 10 10 10 10 10 10 10 10 10 10 10 10 10 10 10 10 10 10 10 10 10 10 10 10 10 10 10 10 10 10 10 10 10 10 10 15 11 0 8 9 9 9 4 0 11 14 10 10 15 11 0 11 0 0 0 0 0 0 0 0 0 0 0 0 0 0 11 0 11 0 11 11 11 24 24 0 11 0 11 10 11 0 11 14 10 10 10 10 10 10 
10 10 10 10 10 10 10 10 10 10 10 10 10 10 10 10 10 10 10 10 10 10 10 10 10 10 10 10 10 10 10 10 10 10 10 10 10 10 10 10 10 10 10 10 10 15 11 0 8 9 9 9 4 0 24 14 10 10 15 24 0 11 0 11 11 24 11 11 24 0 24 11 11 11 11 0 24 0 24 0 11 0 0 0 0 0 11 0 11 10 24 0 24 14 10 10 10 10 10 10 
10 10 10 10 10 10 10 10 10 10 10 10 10 10 10 10 10 10 10 10 10 10 10 10 10 10 10 10 10 10 10 10 10 10 10 10 10 10 10 10 10 10 10 10 10 15 11 0 7 6 6 6 5 0 11 14 10 10 15 11 0 11 0 11 9 0 11 24 11 0 0 0 0 9 11 0 11 0 11 0 24 0 11 11 24 11 11 0 24 10 11 0 11 14 10 10 10 10 10 10 
10 10 10 10 10 10 10 10 10 10 10 10 10 10 10 10 17 12 12 12 12 12 12 12 12 12 19 10 10 10 10 10 10 10 10 10 10 10 10 10 10 10 10 10 10 15 24 11 0 0 0 0 0 11 11 14 10 10 15 11 0 11 0 24 11 0 11 24 11 11 11 24 24 11 11 0 11 0 11 0 11 0 0 0 11 9 11 0 11 11 11 0 11 14 10 10 10 10 10 10 
10 10 10 10 10 10 10 10 10 10 10 10 17 12 12 12 21 11 11 24 11 11 11 11 24 24 20 12 12 12 19 10 10 10 10 10 10 10 10 10 10 10 10 10 10 16 22 11 24 11 11 11 11 11 23 18 10 17 21 11 9 11 0 0 0 0 0 0 0 0 0 0 0 0 11 0 11 0 0 0 0 0 11 0 0 0 11 0 0 0 0 0 11 20 19 10 10 10 10 10 
10 10 10 10 10 10 10 10 10 10 17 12 21 11 11 11 24 24 0 0 1 2 3 0 0 11 11 24 11 11 20 12 19 10 10 10 10 10 10 10 10 10 10 10 10 10 16 13 13 13 13 13 13 13 18 10 10 15 24 11 24 24 11 11 11 11 11 24 24 11 11 11 11 11 11 11 24 11 11 11 24 24 24 11 11 11 11 11 11 11 24 11 11 11 14 10 10 10 10 10 
10 10 10 10 10 10 10 10 10 17 21 11 24 11 1 2 3 0 0 0 8 9 4 0 0 0 1 2 3 11 11 11 20 19 10 10 10 10 10 10 10 10 10 10 10 10 10 10 10 10 10 10 10 10 10 10 10 15 24 11 23 13 13 13 13 13 13 13 13 13 13 13 13 13 13 13 13 13 13 13 13 13 13 13 13 13 13 13 13 13 13 22 11 11 14 10 10 10 10 10 
10 10 10 10 10 10 10 10 17 21 24 11 0 0 8 9 4 0 0 0 7 6 5 0 0 0 8 9 4 0 0 24 11 20 19 10 10 10 10 10 10 10 10 10 10 10 10 10 10 10 10 10 10 10 10 10 10 16 13 13 18 10 10 10 10 10 10 10 10 10 10 10 10 10 10 10 10 10 10 10 10 10 10 10 10 10 10 10 10 10 10 16 13 13 18 10 10 10 10 10 
10 10 10 10 10 10 10 17 21 11 11 0 0 0 7 6 5 11 0 0 11 24 24 0 0 11 7 6 5 0 0 0 11 11 20 19 10 10 10 10 10 10 10 10 10 10 10 10 10 10 10 10 10 10 10 10 10 10 10 10 10 10 10 10 10 10 10 10 10 10 10 10 10 10 10 10 10 10 10 10 10 10 10 10 10 10 10 10 10 10 10 10 10 10 10 10 10 10 10 10 
10 10 10 10 10 10 10 15 24 11 0 0 0 0 0 0 24 11 0 0 0 0 0 0 0 24 11 0 0 0 0 0 0 24 24 14 10 10 10 10 10 10 10 10 10 10 10 10 10 10 10 10 10 10 10 10 10 10 10 10 10 10 10 10 10 10 10 10 10 10 10 10 10 10 10 10 10 10 10 10 10 10 10 10 10 10 10 10 10 10 10 10 10 10 10 10 10 10 10 10 
10 10 10 10 10 10 10 15 24 0 0 0 0 0 0 0 0 0 0 0 1 2 3 0 0 0 0 0 0 0 0 0 0 0 11 14 10 10 10 10 10 10 10 10 10 10 10 10 10 10 10 10 10 10 10 10 10 10 10 10 10 10 10 10 10 10 10 10 10 10 10 10 10 10 10 10 10 10 10 10 10 10 10 10 10 10 10 10 10 10 10 10 10 10 10 10 10 10 10 10 
10 10 10 10 10 10 17 21 11 0 0 0 0 0 11 11 24 0 0 0 8 9 4 0 0 0 11 11 11 0 0 0 0 0 11 20 19 10 10 10 10 10 10 10 10 10 10 10 10 10 10 10 10 10 10 10 10 10 10 10 10 10 10 10 10 10 10 10 10 10 10 10 10 10 10 10 10 10 10 10 10 10 10 10 10 10 10 10 10 10 10 10 10 10 10 10 10 10 10 10 
10 10 10 10 10 10 15 11 11 0 0 0 0 0 0 0 11 0 0 0 7 6 5 0 0 0 24 0 0 0 0 0 0 0 24 11 14 10 10 10 10 10 10 10 10 10 10 10 10 10 10 10 10 10 10 10 10 10 10 10 10 10 10 10 10 10 10 10 10 10 10 10 10 10 10 10 10 10 10 10 10 10 10 10 10 10 10 10 10 10 10 10 10 10 10 10 10 10 10 10 
10 10 10 10 10 10 15 24 0 0 0 0 1 2 3 0 11 0 0 0 0 0 0 0 0 0 24 0 1 2 3 0 0 0 0 11 14 10 10 10 10 10 10 10 10 10 10 10 10 10 10 10 10 10 10 10 10 10 10 10 10 10 10 10 10 10 10 10 10 10 10 10 10 10 10 17 12 12 12 12 12 12 12 12 12 12 12 12 12 12 12 19 10 10 10 10 10 10 10 10 
10 10 10 10 10 10 15 11 0 11 11 0 8 9 4 0 0 0 0 11 11 11 24 24 0 0 0 0 8 9 4 0 11 11 0 11 14 10 10 10 10 10 10 10 10 10 10 10 10 10 10 10 10 10 10 10 10 10 10 10 10 10 10 10 10 10 10 10 10 10 10 10 10 10 10 15 11 11 11 11 11 11 11 11 11 11 11 11 11 11 11 14 10 10 10 10 10 10 10 10 
10 10 10 10 10 10 15 11 0 0 11 0 7 6 5 0 0 0 0 0 1 2 3 0 0 0 0 0 7 6 5 0 11 0 0 11 14 10 10 10 10 10 10 10 10 10 10 10 10 10 10 10 10 10 10 10 10 10 10 10 10 10 10 10 10 10 10 10 10 10 10 10 10 10 10 15 11 1 2 3 0 0 1 2 3 0 0 1 2 3 11 14 10 10 10 10 10 10 10 10 
10 10 10 10 10 10 15 11 0 0 0 0 0 0 0 0 0 0 0 0 8 9 4 0 0 0 0 0 0 0 0 0 0 0 0 24 14 10 10 10 10 10 10 10 10 10 10 10 10 10 10 10 10 10 10 10 10 10 10 10 10 10 10 10 10 10 10 10 10 10 10 10 10 10 10 15 11 7 6 5 0 0 7 6 5 0 0 7 6 5 11 14 10 10 10 10 10 10 10 10 
10 10 10 10 10 10 15 24 24 11 11 0 0 0 0 0 0 0 0 0 7 6 5 0 0 0 0 0 0 0 0 0 11 11 24 24 14 10 10 10 10 10 10 10 10 10 10 10 10 10 10 10 10 10 10 10 10 10 10 10 10 10 10 10 10 10 10 10 10 10 10 10 10 10 10 15 11 11 11 11 11 11 11 11 11 11 11 11 11 11 11 14 10 10 10 10 10 10 10 10 
10 10 10 10 10 10 16 13 13 22 11 11 24 11 11 24 11 11 11 11 24 24 24 11 11 11 11 11 11 11 24 11 11 23 13 13 18 10 10 10 10 10 10 10 10 10 10 10 10 10 10 10 10 10 10 10 10 10 10 10 10 10 10 10 10 10 10 10 10 10 10 10 10 10 10 16 13 13 13 13 13 13 13 13 13 13 13 13 13 13 13 18 10 10 10 10 10 10 10 10 
10 10 10 10 10 10 10 10 10 16 13 13 13 13 13 13 13 13 13 13 13 13 13 13 13 13 13 13 13 13 13 13 13 18 10 10 10 10 10 10 10 10 10 10 10 10 10 10 10 10 10 10 10 10 10 10 10 10 10 10 10 10 10 10 10 10 10 10 10 10 10 10 10 10 10 10 10 10 10 10 10 10 10 10 10 10 10 10 10 10 10 10 10 10 10 10 10 10 10 10 
10 10 10 10 10 10 10 10 10 10 10 10 10 10 10 10 10 10 10 10 10 10 10 10 10 10 10 10 10 10 10 10 10 10 10 10 10 10 10 10 10 10 10 10 10 10 10 10 10 10 10 10 10 10 10 10 10 10 10 10 10 10 10 10 10 10 10 10 10 10 10 10 10 10 10 10 10 10 10 10 10 10 10 10 10 10 10 10 10 10 10 10 10 10 10 10 10 10 10 10 
10 10 10 10 10 10 10 10 10 10 10 10 10 10 10 10 10 10 10 10 10 10 10 10 10 10 10 10 10 10 10 10 10 10 10 10 10 10 10 10 10 10 10 10 10 10 10 10 10 10 10 10 10 10 10 10 10 10 10 10 10 10 10 10 10 10 10 10 10 10 10 10 10 10 10 10 10 10 10 10 10 10 10 10 10 10 10 10 10 10 10 10 10 10 10 10 10 10 10 10 
10 10 10 10 10 10 10 10 10 10 10 10 10 10 10 10 10 10 10 10 10 10 10 10 10 10 10 10 10 10 10 10 10 10 10 10 10 10 10 10 10 10 10 10 10 10 10 10 10 10 10 10 10 10 10 10 10 10 10 10 10 10 10 10 10 10 10 10 10 10 10 10 10 10 10 10 10 10 10 10 10 10 10 10 10 10 10 10 10 10 10 10 10 10 10 10 10 10 10 10 
10 10 10 10 10 10 10 10 10 10 10 10 10 10 10 10 10 10 10 10 10 10 10 10 10 10 10 10 10 10 10 10 10 10 10 10 10 10 10 10 10 10 10 10 10 10 10 10 10 10 10 10 10 10 10 10 10 10 10 10 10 10 10 10 10 10 10 10 10 10 10 10 10 10 10 10 10 10 10 10 10 10 10 10 10 10 10 10 10 10 10 10 10 10 10 10 10 10 10 10 
10 10 10 10 10 10 10 10 10 10 10 10 10 10 10 10 10 10 10 10 10 10 10 10 10 10 10 10 10 10 10 10 10 10 10 10 10 10 10 10 10 10 10 10 10 10 10 10 10 10 10 10 10 10 10 10 10 10 10 10 10 10 10 10 10 10 10 10 10 10 10 10 10 10 10 10 10 10 10 10 10 10 10 10 10 10 10 10 10 10 10 10 10 10 10 10 10 10 10 10 
