50 50 50 50 50 50 50 50 50 51 50 50 50 50 50 50 50 50 50 50 50 50 50 50 3 3 3 3 3 3 3 3 3 3 3 3 3 3 3 3 3 3 3 3 3 3 3 3 3 3 3 3 3 3 3 3 3 3 3 3 3 3 3 3 3 3 3 3 3 3 3 3 3 3 3 3 3 3 3 3 3 3 3 3 3 3 3 3 50 50 51 50 50 50 50 50 50 50 50 50 
50 50 50 50 50 50 50 50 50 50 50 50 50 50 50 50 50 50 50 51 50 50 50 50 3 3 3 3 3 3 3 3 3 3 3 3 3 3 3 3 3 3 3 3 3 3 3 3 3 3 3 3 3 3 3 3 3 3 3 3 3 3 3 3 3 3 3 3 3 3 3 3 3 3 3 3 3 3 3 3 3 3 3 3 3 3 3 3 50 50 50 50 50 50 50 50 50 50 50 50 
50 50 50 50 50 50 50 50 50 50 50 50 50 50 50 50 50 50 50 50 50 50 50 50 3 3 3 3 3 3 3 3 3 18 18 18 18 3 3 3 3 3 3 3 3 3 3 3 3 3 3 3 3 3 3 3 3 3 3 3 3 3 3 3 3 3 3 3 3 3 3 3 3 3 3 3 3 3 3 3 3 3 3 3 3 3 3 3 50 50 50 51 50 50 50 50 50 50 51 50 
50 50 51 50 50 50 50 51 50 50 50 50 50 50 50 51 50 50 50 50 51 50 50 50 3 3 3 3 3 3 3 18 18 18 18 18 18 3 3 3 3 3 3 3 3 3 3 3 3 3 3 3 3 3 3 3 3 3 3 3 3 3 3 3 3 3 3 3 3 3 3 3 3 3 3 3 3 3 3 3 3 3 3 3 3 3 3 3 50 50 50 50 50 50 50 50 50 50 50 50 
50 50 51 50 50 50 50 50 50 50 50 50 50 50 50 51 50 50 50 50 50 50 50 50 3 3 3 3 3 3 3 3 18 18 18 18 18 18 3 3 3 3 3 3 3 3 3 3 3 3 3 3 3 3 3 3 3 3 3 3 3 3 3 3 3 3 3 3 3 3 3 3 3 3 3 3 3 3 3 3 3 3 3 3 3 3 3 3 50 51 50 50 50 50 50 50 50 50 50 50 
50 50 50 50 50 50 50 60 57 57 57 57 57 57 57 57 57 57 57 57 57 57 57 57 3 3 3 3 3 3 3 18 18 18 18 18 18 18 3 3 3 3 3 3 3 3 3 3 3 3 3 3 3 3 3 3 3 3 3 3 3 3 3 3 3 3 3 3 3 3 3 3 3 3 3 3 3 3 3 3 3 3 3 3 3 3 3 3 57 57 57 57 61 50 50 50 50 50 50 50 
50 50 50 50 50 51 50 55 13 13 13 13 13 13 13 13 13 13 13 13 13 13 10 10 3 3 3 3 3 3 3 18 18 18 18 18 18 18 3 3 3 3 3 3 3 3 3 3 3 3 3 3 3 3 3 3 3 3 3 3 3 3 3 3 3 3 3 3 3 3 3 3 3 3 3 3 3 3 3 3 3 3 3 3 3 3 3 3 13 13 13 13 59 50 50 50 50 50 50 50 
50 50 50 50 50 50 50 55 13 10 10 10 13 13 13 13 13 13 13 13 13 13 10 31 3 3 3 3 3 3 3 18 18 18 18 18 18 3 3 3 3 3 3 3 3 3 3 3 3 3 3 3 3 3 3 3 3 3 3 3 3 3 3 3 3 3 3 3 3 3 3 3 3 3 3 3 3 3 3 3 3 3 3 3 3 3 3 3 10 10 10 13 59 50 50 50 50 50 50 50 
50 50 50 50 50 50 50 55 13 10 12 10 13 13 13 13 13 13 13 13 10 10 10 38 3 3 3 3 3 3 3 3 3 3 3 3 3 3 3 3 3 3 3 3 3 3 3 3 3 3 3 3 3 3 3 3 3 3 3 3 3 3 3 3 3 3 3 3 3 3 3 3 3 3 3 3 3 3 3 3 3 3 3 3 3 3 3 3 53 54 10 13 59 50 50 50 50 50 50 50 
50 50 50 50 50 50 50 55 13 10 10 10 13 13 13 13 13 13 13 13 10 13 10 38 3 3 3 3 3 3 3 3 3 3 3 3 3 3 3 3 3 3 3 3 3 3 3 3 3 3 3 3 3 3 3 3 3 3 3 3 3 3 3 3 3 3 3 3 3 3 3 3 3 3 3 3 3 3 3 3 3 3 3 3 3 3 3 3 50 55 10 13 59 50 51 50 50 50 50 50 
50 50 50 50 50 50 50 55 13 10 10 13 13 13 13 13 13 13 13 13 10 10 11 38 3 3 3 3 3 3 3 3 3 3 3 3 3 3 3 3 3 3 3 3 3 3 3 3 3 3 3 3 3 3 3 3 3 3 3 3 3 3 3 3 3 3 3 3 3 3 3 3 3 3 3 3 3 3 3 3 3 3 3 3 3 3 3 3 60 56 10 13 59 50 51 50 50 50 50 50 
50 50 50 50 50 50 50 55 13 10 10 13 13 13 13 13 13 13 13 13 13 13 10 38 3 3 3 3 3 3 3 3 3 3 3 3 3 3 3 3 3 3 3 3 3 3 3 3 3 3 3 3 3 3 3 3 3 3 3 3 3 3 3 3 3 3 3 3 3 3 3 3 3 3 3 3 3 3 3 3 3 3 3 3 3 3 3 3 56 10 10 13 59 50 50 50 50 50 50 50 
50 51 50 50 50 50 50 55 13 10 10 13 13 13 13 13 13 13 13 13 13 13 10 38 3 3 3 3 3 3 3 3 3 3 3 3 3 3 3 3 3 3 3 3 3 3 3 3 3 3 3 3 3 3 3 3 3 3 3 3 3 3 3 3 3 3 3 3 3 3 3 3 3 3 3 3 3 3 3 3 3 3 3 3 3 3 3 3 10 10 10 13 59 51 50 50 50 50 50 50 
50 50 50 50 50 50 50 55 13 10 10 13 13 13 13 13 13 13 13 13 13 13 10 38 3 3 3 3 3 3 3 3 3 3 3 3 3 3 3 3 3 3 3 3 3 3 3 3 3 3 3 3 3 3 3 3 3 3 3 3 3 3 3 3 3 3 3 3 3 3 3 3 3 3 3 3 3 3 3 3 3 3 3 3 3 3 3 3 13 13 13 13 59 50 50 50 50 50 50 50 
50 50 50 50 50 50 50 55 31 32 32 32 32 32 32 32 32 32 32 32 32 32 32 39 3 3 3 3 3 3 3 3 3 3 3 3 3 3 3 3 3 3 3 3 3 3 3 3 3 3 3 3 3 3 3 3 3 3 3 3 3 3 3 3 3 3 3 3 3 3 3 3 3 3 3 3 3 3 3 3 3 3 3 3 3 3 3 3 13 13 13 13 59 50 50 50 50 50 50 50 
50 50 50 50 50 50 50 55 38 30 30 30 30 30 30 30 30 30 30 30 30 30 30 30 3 3 3 3 3 3 3 3 3 3 3 3 3 3 3 3 3 3 3 3 3 3 3 3 3 3 3 3 3 3 3 3 3 3 3 3 3 3 3 3 3 3 3 3 3 3 3 3 3 3 3 3 3 3 3 3 3 3 3 3 3 3 3 3 13 13 13 13 59 50 50 50 50 50 50 50 
50 50 50 50 50 51 50 55 37 36 36 36 36 36 36 36 36 36 36 36 36 36 36 36 3 3 3 3 3 3 3 3 3 3 3 3 3 3 3 3 3 3 3 3 3 3 3 3 3 3 3 3 3 3 3 3 3 3 3 3 3 3 3 3 3 3 3 3 3 3 3 3 3 3 3 3 3 3 3 3 3 3 3 3 3 3 3 3 13 13 13 13 59 50 50 50 50 51 50 50 
50 50 50 50 50 50 50 55 13 13 13 13 13 13 13 13 13 13 13 13 13 13 10 10 3 3 3 3 3 3 3 3 3 3 3 3 3 3 3 3 3 3 3 3 3 3 3 3 3 3 3 3 3 3 3 3 3 3 3 3 3 3 3 3 3 3 3 3 3 3 3 3 3 3 3 3 3 3 3 3 3 3 3 3 3 3 3 3 13 13 13 13 59 50 50 50 50 50 50 50 
50 50 50 51 50 50 50 55 13 13 13 13 13 13 13 13 13 13 13 13 13 13 10 10 3 3 3 3 3 3 3 3 3 3 3 3 3 3 3 3 3 3 3 3 3 3 3 3 3 3 3 3 3 3 3 3 3 3 3 3 3 3 3 3 3 3 3 3 3 3 3 3 3 3 3 3 3 3 3 3 3 3 3 3 3 3 3 3 13 13 13 13 59 50 50 50 50 50 50 50 
50 50 50 51 50 50 50 55 13 13 13 13 13 13 13 13 13 13 13 13 13 13 10 10 3 3 3 3 3 3 3 3 3 3 3 3 3 3 3 3 3 3 3 3 3 3 3 3 3 3 3 3 3 3 3 3 3 3 3 3 3 3 3 3 3 3 3 3 3 3 3 3 3 3 3 3 3 3 3 3 3 3 3 3 3 3 3 3 13 13 13 13 59 50 50 50 50 50 50 50 
50 50 50 50 50 50 50 55 13 13 13 13 13 13 13 13 13 13 13 13 13 13 10 10 3 3 3 3 3 3 3 3 3 3 3 3 3 3 3 3 3 3 3 3 3 3 3 3 3 3 3 3 3 3 3 3 3 3 3 3 3 3 3 3 3 3 3 3 3 3 3 3 3 3 3 3 3 3 3 3 3 3 3 3 3 3 3 3 13 13 13 13 59 50 50 51 50 50 50 50 
50 50 50 50 50 50 50 55 13 13 13 13 13 13 13 13 13 13 13 13 13 13 10 10 3 3 3 3 3 3 3 3 3 3 3 3 3 3 3 3 3 3 3 3 3 3 3 3 3 3 3 3 3 3 3 3 3 3 3 3 3 3 3 3 3 3 3 3 3 3 3 3 3 3 3 3 3 3 3 3 3 3 3 3 3 3 3 3 13 13 13 13 59 50 50 51 50 50 50 50 
50 50 50 50 50 50 51 55 13 13 13 13 10 10 10 13 13 13 13 13 13 13 10 11 3 3 3 3 3 3 3 3 3 3 3 3 3 3 3 3 3 3 3 3 3 3 3 3 3 3 3 3 3 3 3 3 3 3 3 3 3 3 3 3 3 3 3 3 3 3 3 3 3 3 3 3 3 3 3 3 3 3 3 3 3 3 3 3 13 13 13 13 59 50 50 50 50 50 50 50 
50 50 50 50 50 50 50 55 13 13 13 13 10 10 10 13 13 13 13 13 13 13 10 10 3 3 3 3 3 3 3 3 3 3 3 3 3 3 3 3 3 3 3 3 3 3 3 3 3 3 3 3 3 3 3 3 3 3 3 3 3 3 3 3 3 3 3 3 3 3 3 3 3 3 3 3 3 3 3 3 3 3 3 3 3 3 3 3 13 13 13 13 59 50 50 50 50 50 50 50 
50 50 50 50 50 50 50 55 13 13 10 13 13 10 13 13 13 13 13 13 13 13 10 10 3 3 3 3 3 3 3 3 3 3 3 3 3 3 3 3 3 3 3 3 3 3 3 3 3 3 3 3 3 3 3 3 3 3 3 3 3 3 3 3 3 3 3 3 3 3 3 3 3 3 3 3 3 3 3 3 3 3 3 3 3 3 3 3 13 13 13 13 59 50 50 50 50 50 50 50 
50 50 50 50 50 50 50 55 13 13 13 13 13 10 13 13 13 13 13 13 13 13 10 10 3 3 3 3 3 3 3 3 3 3 3 3 3 3 3 3 3 3 3 3 3 3 3 3 3 3 3 3 3 3 3 3 3 3 3 3 3 3 3 3 3 3 3 3 3 3 3 3 3 3 3 3 3 3 3 3 3 3 3 3 3 3 3 3 13 13 13 13 59 50 50 50 50 50 50 50 
50 50 50 50 50 50 50 55 13 13 13 13 13 10 13 13 10 13 31 32 33 13 10 10 3 3 3 3 3 3 3 3 3 3 3 3 3 3 3 3 3 3 3 3 3 3 3 3 3 3 3 3 3 3 3 3 3 3 3 3 3 3 3 3 3 3 3 3 3 3 3 3 3 3 3 3 3 3 3 3 3 3 3 3 3 3 3 3 13 13 13 13 59 50 50 50 50 50 50 50 
50 50 50 50 50 50 50 55 13 13 13 13 13 10 13 13 13 10 38 30 34 13 10 10 3 3 3 3 3 3 3 3 3 3 3 3 3 3 3 3 3 3 3 3 3 3 3 3 3 3 3 3 3 3 3 3 3 3 3 3 3 3 3 3 3 3 3 3 3 3 3 3 3 3 3 3 3 3 3 3 3 3 3 3 3 3 3 3 13 13 13 13 59 50 50 50 50 50 50 50 
50 50 50 50 50 50 50 55 13 10 10 10 10 10 13 13 13 10 37 36 35 13 10 10 3 3 3 3 3 3 3 3 3 3 3 3 3 3 3 3 3 3 3 3 3 3 3 3 3 3 3 3 3 3 3 3 3 3 3 3 3 3 3 3 3 3 3 3 3 3 3 3 3 3 3 3 3 3 3 3 3 3 3 3 3 3 3 3 13 13 13 13 13 59 50 50 50 50 50 50 
50 50 50 50 50 50 50 55 13 10 13 13 13 13 13 13 13 10 13 13 13 13 10 10 3 3 3 3 3 3 3 3 3 3 3 3 3 3 3 3 3 3 3 3 3 3 3 3 3 3 3 3 3 3 3 3 3 3 3 3 3 3 3 3 3 3 3 3 3 3 3 3 3 3 3 3 3 3 3 3 3 3 3 3 3 3 3 3 13 13 13 13 59 50 50 50 50 50 50 50 
50 50 50 50 50 50 50 55 13 10 13 13 13 13 13 10 13 10 13 13 13 13 10 10 3 3 3 3 3 3 3 3 3 3 3 3 3 3 3 3 3 3 3 3 3 3 3 3 3 3 3 3 3 3 3 3 3 3 3 3 3 3 3 3 3 3 3 3 3 3 3 3 3 3 3 3 3 3 3 3 3 3 3 3 3 3 3 3 13 13 13 13 59 50 50 50 50 50 50 50 
50 50 50 50 50 50 50 55 13 10 13 13 13 13 13 13 13 10 13 13 10 13 11 10 3 3 3 3 3 3 3 3 3 3 3 3 3 3 3 3 3 3 3 3 3 3 3 3 3 3 3 3 3 3 3 3 3 3 3 3 3 3 3 3 3 3 3 3 3 3 3 3 3 3 3 3 3 3 3 3 3 3 3 3 3 3 3 3 13 13 13 13 59 50 50 50 50 50 50 50 
50 50 50 50 50 50 50 55 13 10 13 13 13 13 13 13 13 10 13 13 13 13 10 10 3 3 3 3 3 3 3 3 3 3 3 3 3 3 3 3 3 3 3 3 3 3 3 3 3 3 3 3 3 3 3 3 3 3 3 3 3 3 3 3 3 3 3 3 3 3 3 3 3 3 3 3 3 3 3 3 3 3 3 3 3 3 3 3 13 13 13 13 59 50 50 50 50 50 50 50 
50 50 50 50 50 50 50 55 13 10 13 13 13 13 13 13 13 10 13 13 13 13 10 10 3 3 3 3 3 3 3 3 3 3 3 3 3 3 3 3 3 3 3 3 3 3 3 3 3 3 3 3 3 3 3 3 3 3 3 3 3 3 3 3 3 3 3 3 3 3 3 3 3 3 3 3 3 3 3 3 3 3 3 3 3 3 3 3 13 13 13 13 59 50 50 50 50 50 50 50 
50 50 50 50 50 50 50 55 13 10 10 10 10 10 10 10 10 10 13 13 13 13 10 10 3 3 3 3 3 3 3 3 3 3 3 3 3 3 3 3 3 3 3 3 3 3 3 3 3 3 3 3 3 3 3 3 3 3 3 3 3 3 3 3 3 3 3 3 3 3 3 3 3 3 3 3 3 3 3 3 3 3 3 3 3 3 3 3 13 13 13 13 59 50 50 50 51 50 50 50 
50 50 50 50 50 50 51 55 13 13 13 13 13 10 13 13 13 13 13 13 13 10 10 10 3 3 3 3 3 3 3 3 3 3 3 3 3 3 3 3 3 3 3 3 3 3 3 3 3 3 3 3 3 3 3 3 3 3 3 3 3 3 3 3 3 3 3 3 3 3 3 3 3 3 3 3 3 3 3 3 3 3 3 3 3 3 3 3 13 13 13 13 59 50 50 50 50 50 50 50 
50 50 50 50 50 50 50 55 13 10 13 13 13 10 13 13 13 13 13 13 13 10 43 43 43 43 43 10 13 13 13 13 13 13 13 13 13 13 13 13 13 13 59 50 50 50 50 50 50 50 50 50 50 50 50 50 50 55 13 10 13 13 13 10 13 13 13 13 13 13 13 10 43 43 43 43 43 10 13 13 13 13 13 13 13 13 13 13 13 13 13 13 59 50 50 50 50 50 50 50 
50 50 50 50 50 50 50 55 13 13 13 13 13 10 13 13 13 13 13 13 13 10 43 31 32 33 43 10 13 13 13 13 13 13 13 13 13 13 13 13 13 13 59 51 50 50 50 50 50 50 50 50 50 50 50 50 50 55 13 13 13 13 13 10 13 13 13 13 13 13 13 10 43 31 32 33 43 10 13 13 13 13 13 13 13 13 13 13 13 13 13 13 59 51 50 50 50 50 50 50 
50 50 50 50 50 50 50 55 13 13 10 10 10 10 13 13 13 13 13 13 13 10 43 38 30 34 43 10 13 13 13 13 13 13 13 13 13 13 13 13 13 13 59 50 50 50 50 50 50 50 50 50 50 50 50 50 50 55 13 13 10 10 10 10 13 13 13 13 13 13 13 10 43 38 30 34 43 10 13 13 13 13 13 13 13 13 13 13 13 13 13 13 59 50 50 50 50 50 50 50 
50 50 50 50 50 50 50 55 13 13 10 13 13 13 13 13 13 13 13 13 13 10 43 38 30 34 43 10 13 13 13 13 13 13 13 13 13 13 13 13 13 13 59 50 50 50 50 50 50 50 50 50 50 50 50 50 50 55 13 13 10 13 13 13 13 13 13 13 13 13 13 10 43 38 30 34 43 10 13 13 13 13 13 13 13 13 13 13 13 13 13 13 59 50 50 50 50 50 50 50 
50 50 50 50 50 50 50 55 13 13 10 13 13 13 13 13 13 13 13 13 13 10 43 37 36 35 43 10 13 13 13 13 13 13 13 13 13 13 13 13 13 13 59 50 50 51 50 50 50 50 50 50 50 50 50 50 50 55 13 13 10 13 13 13 13 13 13 13 13 13 13 10 43 37 36 35 43 10 13 13 13 13 13 13 13 13 13 13 13 13 13 13 59 50 50 51 50 50 50 50 
50 50 50 50 51 50 50 55 13 10 10 10 10 10 10 10 10 10 10 10 10 10 43 43 43 43 43 10 11 10 10 10 10 10 10 10 10 10 10 10 10 13 59 50 50 51 50 50 50 50 50 50 50 50 51 50 50 55 13 10 10 10 10 10 10 10 10 10 10 10 10 10 43 43 43 43 43 10 11 10 10 10 10 10 10 10 10 10 10 10 10 13 59 50 50 51 50 50 50 50 
50 50 50 50 51 50 50 55 13 10 10 10 10 10 10 12 10 10 10 10 10 10 10 10 10 10 10 10 10 10 10 10 10 10 10 10 10 10 10 10 10 13 59 50 50 50 50 50 50 50 50 50 50 50 51 50 50 55 13 10 10 10 10 10 10 12 10 10 10 10 10 10 10 10 10 10 10 10 10 10 10 10 10 10 10 10 10 10 10 10 10 13 59 50 50 50 50 50 50 50 
50 50 50 50 50 50 50 55 13 13 13 13 13 13 13 13 13 13 13 13 13 10 10 10 10 10 10 10 13 13 13 13 13 13 13 13 13 13 13 13 13 13 59 50 50 50 50 50 50 50 50 50 50 50 50 50 50 55 13 13 13 13 13 13 13 13 13 13 13 13 13 10 10 10 10 10 10 10 13 13 13 13 13 13 13 13 13 13 13 13 13 13 59 50 50 50 50 50 50 50 
50 50 50 50 50 50 50 63 53 53 53 53 53 53 53 53 53 53 53 53 53 53 53 53 53 53 53 53 53 53 53 53 53 53 53 53 53 53 53 53 53 53 62 50 50 50 50 50 50 50 50 50 50 50 50 50 50 63 53 53 53 53 53 53 53 53 53 53 53 53 53 53 53 53 53 53 53 53 53 53 53 53 53 53 53 53 53 53 53 53 53 53 62 50 50 50 50 50 50 50 
50 50 51 50 50 50 50 50 50 50 50 50 50 50 50 50 50 50 50 51 50 50 50 50 50 50 50 50 50 50 50 50 51 50 50 50 50 50 50 50 50 50 51 50 50 50 50 50 50 50 50 50 51 50 50 50 50 50 50 50 50 50 50 50 50 50 50 50 50 51 50 50 50 50 50 50 50 50 50 50 50 50 51 50 50 50 50 50 50 50 50 50 51 50 50 50 50 50 50 50 
50 50 50 50 50 50 50 50 50 50 50 50 50 51 50 50 50 50 50 50 50 50 50 50 50 50 50 51 50 50 50 50 50 50 50 50 50 50 50 51 50 50 50 50 50 50 50 50 50 50 50 50 50 50 50 50 50 50 50 50 50 50 50 51 50 50 50 50 50 50 50 50 50 50 50 50 50 51 50 50 50 50 50 50 50 50 50 50 50 51 50 50 50 50 50 50 50 50 50 50 
50 50 50 50 50 51 50 50 50 50 50 50 50 50 50 50 50 50 50 50 50 50 50 50 50 50 50 51 50 50 50 50 50 50 50 50 50 50 50 50 50 50 50 50 50 50 50 50 50 50 50 50 50 50 50 51 50 50 50 50 50 50 50 50 50 50 50 50 50 50 50 50 50 50 50 50 50 51 50 50 50 50 50 50 50 50 50 50 50 50 50 50 50 50 50 50 50 50 50 50 
50 50 50 50 50 50 50 50 51 50 50 50 50 50 50 50 50 50 50 50 50 50 50 50 50 50 50 50 50 50 50 50 50 50 50 51 50 50 50 50 50 50 50 50 51 50 50 50 50 50 50 50 50 50 50 50 50 50 51 50 50 50 50 50 50 50 50 50 50 50 50 50 50 50 50 50 50 50 50 50 50 50 50 50 50 51 50 50 50 50 50 50 50 50 51 50 50 50 50 50 
50 50 50 50 50 50 50 50 50 50 50 50 50 50 50 50 50 50 50 50 51 50 50 50 50 50 50 50 50 50 50 50 50 50 50 50 50 50 50 50 50 50 50 50 50 50 50 50 50 50 50 50 50 50 50 50 50 50 50 50 50 50 50 50 50 50 50 50 50 50 51 50 50 50 50 50 50 50 50 50 50 50 50 50 50 50 50 50 50 50 50 50 50 50 50 50 50 50 50 50 
50 50 50 50 50 50 50 50 50 51 50 50 50 50 50 50 50 50 50 50 50 50 50 50 50 50 50 50 50 50 51 50 50 50 50 50 50 50 50 50 51 50 50 50 50 50 50 50 50 50 50 50 50 50 50 50 50 50 50 51 50 50 50 50 50 50 50 50 50 50 50 50 50 50 50 50 50 50 50 50 51 50 50 50 50 50 50 50 50 50 51 50 50 50 50 50 50 50 50 50 
50 50 50 50 50 50 50 50 50 50 50 50 50 50 50 50 50 50 50 51 50 50 50 50 50 50 50 50 50 50 50 50 50 50 50 50 50 50 50 50 50 50 50 50 50 50 50 50 50 50 50 50 50 50 50 50 50 50 50 50 50 50 50 50 50 50 50 50 50 51 50 50 50 50 50 50 50 50 50 50 50 50 50 50 50 50 50 50 50 50 50 50 50 50 50 50 50 50 50 50 
50 50 50 50 50 50 50 50 50 50 50 50 50 50 50 50 50 50 50 50 50 50 50 50 51 50 50 50 50 50 50 50 50 50 50 50 50 50 50 50 50 51 50 50 50 50 50 50 51 50 50 50 50 50 50 50 50 50 50 50 50 50 50 50 50 50 50 50 50 50 50 50 50 50 51 50 50 50 50 50 50 50 50 50 50 50 50 50 50 50 50 51 50 50 50 50 50 50 51 50 
50 50 51 50 50 50 50 51 50 50 50 50 50 50 50 51 50 50 50 50 51 50 50 50 50 50 50 50 50 50 50 50 50 50 50 50 51 50 50 50 50 50 50 50 50 50 50 50 50 50 50 50 51 50 50 50 50 51 50 50 50 50 50 50 50 51 50 50 50 50 51 50 50 50 50 50 50 50 50 50 50 50 50 50 50 50 51 50 50 50 50 50 50 50 50 50 50 50 50 50 
50 50 51 50 50 50 50 50 50 50 50 50 50 50 50 51 50 50 50 50 50 50 50 50 50 50 51 50 50 50 50 50 50 50 50 50 50 50 50 51 50 50 50 50 50 50 50 50 50 50 50 50 51 50 50 50 50 50 50 50 50 50 50 50 50 51 50 50 50 50 50 50 50 50 50 50 51 50 50 50 50 50 50 50 50 50 50 50 50 51 50 50 50 50 50 50 50 50 50 50 
50 50 50 50 50 50 50 60 57 57 57 57 57 57 57 57 57 57 57 57 57 57 57 57 57 57 57 57 57 57 57 57 57 57 57 57 57 57 57 57 57 57 61 50 50 50 50 50 50 50 50 50 50 50 50 50 50 60 57 57 57 57 57 57 57 57 57 57 57 57 57 57 57 57 57 57 57 57 57 57 57 57 57 57 57 57 57 57 57 57 57 57 61 50 50 50 50 50 50 50 
50 50 50 50 50 51 50 55 13 13 13 13 13 13 13 13 13 13 13 13 13 13 10 10 10 10 10 13 13 13 13 13 13 13 13 13 13 13 13 13 13 13 59 50 50 50 50 50 50 50 50 50 50 50 50 51 50 55 13 13 13 13 13 13 13 13 13 13 13 13 13 13 10 10 10 10 10 13 13 13 13 13 13 13 13 13 13 13 13 13 13 13 59 50 50 50 50 50 50 50 
50 50 50 50 50 50 50 55 13 10 10 10 13 13 13 13 13 13 13 13 13 13 10 31 32 33 10 13 13 13 13 13 13 10 10 10 10 10 10 10 10 13 59 50 50 50 50 50 50 50 50 50 50 50 50 50 50 55 13 10 10 10 13 13 13 13 13 13 13 13 13 13 10 31 32 33 10 13 13 13 13 13 13 10 10 10 10 10 10 10 10 13 59 50 50 50 50 50 50 50 
50 50 50 50 50 50 50 55 13 10 12 10 13 13 13 13 13 13 13 13 10 10 10 38 30 34 10 13 13 13 13 13 13 10 52 53 53 53 53 54 10 13 59 50 50 50 50 50 50 50 50 50 50 50 50 50 50 55 13 10 12 10 13 13 13 13 13 13 13 13 10 10 10 38 30 34 10 13 13 13 13 13 13 10 52 53 53 53 53 54 10 13 59 50 50 50 50 50 50 50 
50 50 50 50 50 50 50 55 13 10 10 10 13 13 13 13 13 13 13 13 10 13 10 38 30 34 10 14 10 10 10 10 10 10 59 50 50 51 50 55 10 13 59 50 51 50 50 50 50 50 50 50 50 50 50 50 50 55 13 10 10 10 13 13 13 13 13 13 13 13 10 13 10 38 30 34 10 14 10 10 10 10 10 10 59 50 50 51 50 55 10 13 59 50 51 50 50 50 50 50 
50 50 50 50 50 50 50 55 13 10 10 13 13 13 13 13 13 13 13 13 10 10 11 38 30 34 10 10 10 10 10 10 10 10 59 50 50 51 60 56 10 13 59 50 51 50 50 50 50 50 50 50 50 50 50 50 50 55 13 10 10 13 13 13 13 13 13 13 13 13 10 10 11 38 30 34 10 10 10 10 10 10 10 10 59 50 50 51 60 56 10 13 59 50 51 50 50 50 50 50 
50 50 50 50 50 50 50 55 13 10 10 13 13 13 13 13 13 13 13 13 13 13 10 38 30 34 10 13 13 13 15 15 15 10 58 57 57 57 56 10 10 13 59 50 50 50 50 50 50 50 50 50 50 50 50 50 50 55 13 10 10 13 13 13 13 13 13 13 13 13 13 13 10 38 30 34 10 13 13 13 15 15 15 10 58 57 57 57 56 10 10 13 59 50 50 50 50 50 50 50 
50 51 50 50 50 50 50 55 13 10 10 13 13 13 13 13 13 13 13 13 13 13 10 38 30 34 10 13 13 13 15 15 15 10 10 10 10 10 10 10 10 13 59 51 50 50 50 50 50 50 50 51 50 50 50 50 50 55 13 10 10 13 13 13 13 13 13 13 13 13 13 13 10 38 30 34 10 13 13 13 15 15 15 10 10 10 10 10 10 10 10 13 59 51 50 50 50 50 50 50 
50 50 50 50 50 50 50 55 13 10 10 13 13 13 13 13 13 13 13 13 13 13 10 38 30 34 10 13 13 13 15 15 15 13 13 13 13 13 13 13 13 13 59 50 50 50 50 50 50 50 50 50 50 50 50 50 50 55 13 10 10 13 13 13 13 13 13 13 13 13 13 13 10 38 30 34 10 13 13 13 15 15 15 13 13 13 13 13 13 13 13 13 59 50 50 50 50 50 50 50 
50 50 50 50 50 50 50 55 31 32 32 32 32 32 32 32 32 32 32 32 32 32 32 39 30 34 10 13 13 13 13 13 13 13 13 13 13 13 13 13 13 13 59 50 50 50 50 50 50 50 50 50 50 50 50 50 50 55 31 32 32 32 32 32 32 32 32 32 32 32 32 32 32 39 30 34 10 13 13 13 13 13 13 13 13 13 13 13 13 13 13 13 59 50 50 50 50 50 50 50 
50 50 50 50 50 50 50 55 38 30 30 30 30 30 30 30 30 30 30 30 30 30 30 30 30 34 10 13 13 13 13 13 13 13 13 13 13 13 13 13 13 13 59 50 50 50 50 50 50 50 50 50 50 50 50 50 50 55 38 30 30 30 30 30 30 30 30 30 30 30 30 30 30 30 30 34 10 13 13 13 13 13 13 13 13 13 13 13 13 13 13 13 59 50 50 50 50 50 50 50 
50 50 50 50 50 51 50 55 37 36 36 36 36 36 36 36 36 36 36 36 36 36 36 36 36 35 10 13 13 13 13 13 13 13 13 13 13 13 13 13 13 13 59 50 50 50 50 51 50 50 50 50 50 50 50 51 50 55 37 36 36 36 36 36 36 36 36 36 36 36 36 36 36 36 36 35 10 13 13 13 13 13 13 13 13 13 13 13 13 13 13 13 59 50 50 50 50 51 50 50 
50 50 50 50 50 50 50 55 13 13 13 13 13 13 13 13 13 13 13 13 13 13 10 10 10 10 12 13 13 13 13 13 13 13 13 13 13 13 13 13 13 13 59 50 50 50 50 50 50 50 50 50 50 50 50 50 50 55 13 13 13 13 13 13 13 13 13 13 13 13 13 13 10 10 10 10 12 13 13 13 13 13 13 13 13 13 13 13 13 13 13 13 59 50 50 50 50 50 50 50 
50 50 50 51 50 50 50 55 13 13 13 13 13 13 13 13 13 13 13 13 13 13 10 10 10 10 10 13 13 13 13 13 13 13 13 13 13 13 13 13 13 13 59 50 50 50 50 50 50 50 50 50 50 51 50 50 50 55 13 13 13 13 13 13 13 13 13 13 13 13 13 13 10 10 10 10 10 13 13 13 13 13 13 13 13 13 13 13 13 13 13 13 59 50 50 50 50 50 50 50 
50 50 50 51 50 50 50 55 13 13 13 13 13 13 13 13 13 13 13 13 13 13 10 10 10 10 10 13 13 13 13 13 13 13 13 13 13 13 13 13 13 13 59 50 50 50 50 50 50 50 50 50 50 51 50 50 50 55 13 13 13 13 13 13 13 13 13 13 13 13 13 13 10 10 10 10 10 13 13 13 13 13 13 13 13 13 13 13 13 13 13 13 59 50 50 50 50 50 50 50 
50 50 50 50 50 50 50 55 13 13 13 13 13 13 13 13 13 13 13 13 13 13 10 10 10 10 10 13 13 13 13 13 13 13 13 13 13 13 13 13 13 13 59 50 50 51 50 50 50 50 50 50 50 50 50 50 50 55 13 13 13 13 13 13 13 13 13 13 13 13 13 13 10 10 10 10 10 13 13 13 13 13 13 13 13 13 13 13 13 13 13 13 59 50 50 51 50 50 50 50 
50 50 50 50 50 50 50 55 13 13 13 13 13 13 13 13 13 13 13 13 13 13 10 10 10 10 10 13 13 13 13 13 13 13 13 13 13 13 13 13 13 13 59 50 50 51 50 50 50 50 50 50 50 50 50 50 50 55 13 13 13 13 13 13 13 13 13 13 13 13 13 13 10 10 10 10 10 13 13 13 13 13 13 13 13 13 13 13 13 13 13 13 59 50 50 51 50 50 50 50 
50 50 50 50 50 50 51 55 13 13 13 13 10 10 10 13 13 13 13 13 13 13 10 11 10 10 10 13 13 13 13 13 13 13 13 13 13 13 13 13 13 13 59 50 50 50 50 50 50 50 50 50 50 50 50 50 51 55 13 13 13 13 10 10 10 13 13 13 13 13 13 13 10 11 10 10 10 13 13 13 13 13 13 13 13 13 13 13 13 13 13 13 59 50 50 50 50 50 50 50 
50 50 50 50 50 50 50 55 13 13 13 13 10 10 10 13 13 13 13 13 13 13 10 10 10 10 10 13 13 13 13 13 13 13 13 13 13 13 13 13 13 13 59 50 50 50 50 50 50 50 50 50 50 50 50 50 50 55 13 13 13 13 10 10 10 13 13 13 13 13 13 13 10 10 10 10 10 13 13 13 13 13 13 13 13 13 13 13 13 13 13 13 59 50 50 50 50 50 50 50 
50 50 50 50 50 50 50 55 13 13 10 13 13 10 13 13 13 13 13 13 13 13 10 10 10 10 10 13 13 13 13 13 13 13 13 13 13 13 13 13 13 13 59 50 50 50 50 50 50 50 50 50 50 50 50 50 50 55 13 13 10 13 13 10 13 13 13 13 13 13 13 13 10 10 10 10 10 13 13 13 13 13 13 13 13 13 13 13 13 13 13 13 59 50 50 50 50 50 50 50 
50 50 50 50 50 50 50 55 13 13 13 13 13 10 13 13 13 13 13 13 13 13 10 10 10 10 10 13 13 13 13 13 13 13 13 13 13 13 13 13 13 13 59 50 50 50 50 50 50 50 50 50 50 50 50 50 50 55 13 13 13 13 13 10 13 13 13 13 13 13 13 13 10 10 10 10 10 13 13 13 13 13 13 13 13 13 13 13 13 13 13 13 59 50 50 50 50 50 50 50 
50 50 50 50 50 50 50 55 13 13 13 13 13 10 13 13 10 13 31 32 33 13 10 10 10 10 10 13 13 13 13 13 13 13 13 13 13 13 13 13 13 13 59 50 50 50 50 50 50 50 50 50 50 50 50 50 50 55 13 13 13 13 13 10 13 13 10 13 31 32 33 13 10 10 10 10 10 13 13 13 13 13 13 13 13 13 13 13 13 13 13 13 59 50 50 50 50 50 50 50 
50 50 50 50 50 50 50 55 13 13 13 13 13 10 13 13 13 10 38 30 34 13 10 10 10 10 10 13 13 13 13 13 13 13 13 13 13 13 13 13 13 13 59 50 50 50 50 50 50 50 50 50 50 50 50 50 50 55 13 13 13 13 13 10 13 13 13 10 38 30 34 13 10 10 10 10 10 13 13 13 13 13 13 13 13 13 13 13 13 13 13 13 59 50 50 50 50 50 50 50 
50 50 50 50 50 50 50 55 13 10 10 10 10 10 13 13 13 10 37 36 35 13 10 10 10 10 10 12 13 13 13 13 13 13 13 13 13 13 13 13 13 13 13 59 50 50 50 50 50 50 50 50 50 50 50 50 50 55 13 10 10 10 10 10 13 13 13 10 37 36 35 13 10 10 10 10 10 12 13 13 13 13 13 13 13 13 13 13 13 13 13 13 13 59 50 50 50 50 50 50 
50 50 50 50 50 50 50 55 13 10 13 13 13 13 13 13 13 10 13 13 13 13 10 10 10 10 10 13 13 13 13 13 13 13 13 13 13 13 13 13 13 13 59 50 50 50 50 50 50 50 50 50 50 50 50 50 50 55 13 10 13 13 13 13 13 13 13 10 13 13 13 13 10 10 10 10 10 13 13 13 13 13 13 13 13 13 13 13 13 13 13 13 59 50 50 50 50 50 50 50 
50 50 50 50 50 50 50 55 13 10 13 13 13 13 13 10 13 10 13 13 13 13 10 10 10 10 10 13 13 13 13 13 13 13 13 13 13 13 13 13 13 13 59 50 50 50 50 50 50 50 50 50 50 50 50 50 50 55 13 10 13 13 13 13 13 10 13 10 13 13 13 13 10 10 10 10 10 13 13 13 13 13 13 13 13 13 13 13 13 13 13 13 59 50 50 50 50 50 50 50 
50 50 50 50 50 50 50 55 13 10 13 13 13 13 13 13 13 10 13 13 10 13 11 10 10 10 10 13 13 13 13 13 13 13 13 13 13 13 13 13 13 13 59 50 50 50 50 50 50 50 50 50 50 50 50 50 50 55 13 10 13 13 13 13 13 13 13 10 13 13 10 13 11 10 10 10 10 13 13 13 13 13 13 13 13 13 13 13 13 13 13 13 59 50 50 50 50 50 50 50 
50 50 50 50 50 50 50 55 13 10 13 13 13 13 13 13 13 10 13 13 13 13 10 10 10 10 10 13 13 13 13 13 13 13 13 13 13 13 13 13 13 13 59 50 50 50 50 50 50 50 50 50 50 50 50 50 50 55 13 10 13 13 13 13 13 13 13 10 13 13 13 13 10 10 10 10 10 13 13 13 13 13 13 13 13 13 13 13 13 13 13 13 59 50 50 50 50 50 50 50 
50 50 50 50 50 50 50 55 13 10 13 13 13 13 13 13 13 10 13 13 13 13 10 10 10 10 10 13 13 13 13 13 13 13 13 13 13 13 13 13 13 13 59 50 50 50 50 50 50 50 50 50 50 50 50 50 50 55 13 10 13 13 13 13 13 13 13 10 13 13 13 13 10 10 10 10 10 13 13 13 13 13 13 13 13 13 13 13 13 13 13 13 59 50 50 50 50 50 50 50 
50 50 50 50 50 50 50 55 13 10 10 10 10 10 10 10 10 10 13 13 13 13 10 10 10 10 10 13 13 13 13 13 13 13 13 13 13 13 13 13 13 13 59 50 50 50 51 50 50 50 50 50 50 50 50 50 50 55 13 10 10 10 10 10 10 10 10 10 13 13 13 13 10 10 10 10 10 13 13 13 13 13 13 13 13 13 13 13 13 13 13 13 59 50 50 50 51 50 50 50 
50 50 50 50 50 50 51 55 13 13 13 13 13 10 13 13 13 13 13 13 13 10 10 10 10 10 12 10 13 13 13 13 13 13 13 13 13 13 13 13 13 13 59 50 50 50 50 50 50 50 50 50 50 50 50 50 51 55 13 13 13 13 13 10 13 13 13 13 13 13 13 10 10 10 10 10 12 10 13 13 13 13 13 13 13 13 13 13 13 13 13 13 59 50 50 50 50 50 50 50 
50 50 50 50 50 50 50 55 13 10 13 13 13 10 13 13 13 13 13 13 13 10 43 43 43 43 43 10 13 13 13 13 13 13 13 13 13 13 13 13 13 13 59 50 50 50 50 50 50 50 50 50 50 50 50 50 50 55 13 10 13 13 13 10 13 13 13 13 13 13 13 10 43 43 43 43 43 10 13 13 13 13 13 13 13 13 13 13 13 13 13 13 59 50 50 50 50 50 50 50 
50 50 50 50 50 50 50 55 13 13 13 13 13 10 13 13 13 13 13 13 13 10 43 31 32 33 43 10 13 13 13 13 13 13 13 13 13 13 13 13 13 13 59 51 50 50 50 50 50 50 50 50 50 50 50 50 50 55 13 13 13 13 13 10 13 13 13 13 13 13 13 10 43 31 32 33 43 10 13 13 13 13 13 13 13 13 13 13 13 13 13 13 59 51 50 50 50 50 50 50 
50 50 50 50 50 50 50 55 13 13 10 10 10 10 13 13 13 13 13 13 13 10 43 38 30 34 43 10 13 13 13 13 13 13 13 13 13 13 13 13 13 13 59 50 50 50 50 50 50 50 50 50 50 50 50 50 50 55 13 13 10 10 10 10 13 13 13 13 13 13 13 10 43 38 30 34 43 10 13 13 13 13 13 13 13 13 13 13 13 13 13 13 59 50 50 50 50 50 50 50 
50 50 50 50 50 50 50 55 13 13 10 13 13 13 13 13 13 13 13 13 13 10 43 38 30 34 43 10 13 13 13 13 13 13 13 13 13 13 13 13 13 13 59 50 50 50 50 50 50 50 50 50 50 50 50 50 50 55 13 13 10 13 13 13 13 13 13 13 13 13 13 10 43 38 30 34 43 10 13 13 13 13 13 13 13 13 13 13 13 13 13 13 59 50 50 50 50 50 50 50 
50 50 50 50 50 50 50 55 13 13 10 13 13 13 13 13 13 13 13 13 13 10 43 37 36 35 43 10 13 13 13 13 13 13 13 13 13 13 13 13 13 13 59 50 50 51 50 50 50 50 50 50 50 50 50 50 50 55 13 13 10 13 13 13 13 13 13 13 13 13 13 10 43 37 36 35 43 10 13 13 13 13 13 13 13 13 13 13 13 13 13 13 59 50 50 51 50 50 50 50 
50 50 50 50 51 50 50 55 13 10 10 10 10 10 10 10 10 10 10 10 10 10 43 43 43 43 43 10 11 10 10 10 10 10 10 10 10 10 10 10 10 13 59 50 50 51 50 50 50 50 50 50 50 50 51 50 50 55 13 10 10 10 10 10 10 10 10 10 10 10 10 10 43 43 43 43 43 10 11 10 10 10 10 10 10 10 10 10 10 10 10 13 59 50 50 51 50 50 50 50 
50 50 50 50 51 50 50 55 13 10 10 10 10 10 10 12 10 10 10 10 10 10 10 10 10 10 10 10 10 10 10 10 10 10 10 10 10 10 10 10 10 13 59 50 50 50 50 50 50 50 50 50 50 50 51 50 50 55 13 10 10 10 10 10 10 12 10 10 10 10 10 10 10 10 10 10 10 10 10 10 10 10 10 10 10 10 10 10 10 10 10 13 59 50 50 50 50 50 50 50 
50 50 50 50 50 50 50 55 13 13 13 13 13 13 13 13 13 13 13 13 13 10 10 10 10 10 10 10 13 13 13 13 13 13 13 13 13 13 13 13 13 13 59 50 50 50 50 50 50 50 50 50 50 50 50 50 50 55 13 13 13 13 13 13 13 13 13 13 13 13 13 10 10 10 10 10 10 10 13 13 13 13 13 13 13 13 13 13 13 13 13 13 59 50 50 50 50 50 50 50 
50 50 50 50 50 50 50 63 53 53 53 53 53 53 53 53 53 53 53 53 53 53 53 53 53 53 53 53 53 53 53 53 53 53 53 53 53 53 53 53 53 53 62 50 50 50 50 50 50 50 50 50 50 50 50 50 50 63 53 53 53 53 53 53 53 53 53 53 53 53 53 53 53 53 53 53 53 53 53 53 53 53 53 53 53 53 53 53 53 53 53 53 62 50 50 50 50 50 50 50 
50 50 51 50 50 50 50 50 50 50 50 50 50 50 50 50 50 50 50 51 50 50 50 50 50 50 50 50 50 50 50 50 51 50 50 50 50 50 50 50 50 50 51 50 50 50 50 50 50 50 50 50 51 50 50 50 50 50 50 50 50 50 50 50 50 50 50 50 50 51 50 50 50 50 50 50 50 50 50 50 50 50 51 50 50 50 50 50 50 50 50 50 51 50 50 50 50 50 50 50 
50 50 50 50 50 50 50 50 50 50 50 50 50 51 50 50 50 50 50 50 50 50 50 50 50 50 50 51 50 50 50 50 50 50 50 50 50 50 50 51 50 50 50 50 50 50 50 50 50 50 50 50 50 50 50 50 50 50 50 50 50 50 50 51 50 50 50 50 50 50 50 50 50 50 50 50 50 51 50 50 50 50 50 50 50 50 50 50 50 51 50 50 50 50 50 50 50 50 50 50 
50 50 50 50 50 51 50 50 50 50 50 50 50 50 50 50 50 50 50 50 50 50 50 50 50 50 50 51 50 50 50 50 50 50 50 50 50 50 50 50 50 50 50 50 50 50 50 50 50 50 50 50 50 50 50 51 50 50 50 50 50 50 50 50 50 50 50 50 50 50 50 50 50 50 50 50 50 51 50 50 50 50 50 50 50 50 50 50 50 50 50 50 50 50 50 50 50 50 50 50 
50 50 50 50 50 50 50 50 51 50 50 50 50 50 50 50 50 50 50 50 50 50 50 50 50 50 50 50 50 50 50 50 50 50 50 51 50 50 50 50 50 50 50 50 51 50 50 50 50 50 50 50 50 50 50 50 50 50 51 50 50 50 50 50 50 50 50 50 50 50 50 50 50 50 50 50 50 50 50 50 50 50 50 50 50 51 50 50 50 50 50 50 50 50 51 50 50 50 50 50 
50 50 50 50 50 50 50 50 50 50 50 50 50 50 50 50 50 50 50 50 51 50 50 50 50 50 50 50 50 50 50 50 50 50 50 50 50 50 50 50 50 50 50 50 50 50 50 50 50 50 50 50 50 50 50 50 50 50 50 50 50 50 50 50 50 50 50 50 50 50 51 50 50 50 50 50 50 50 50 50 50 50 50 50 50 50 50 50 50 50 50 50 50 50 50 50 50 50 50 50 
