19 19 19 19 19 19 19 19 19 19 19 19 19 19 19 19 19 19 19 19 19 19 19 19 19 19 19 19 19 19 19 19 19 19 19 19 19 19 19 19 19 19 19 19 19 19 19 19 19 19 19 19 19 19 19 19 19 19 19 19 19 19 19 19 19 19 19 19 19 19 19 19 19 19 19 19 19 19 19 19 19 19 19 19 19 19 19 19 19 19 19 19 19 19 19 19 19 19 19 19 
19 19 19 19 19 19 19 19 19 19 19 19 19 20 19 19 19 19 19 19 19 19 19 19 19 19 19 20 19 19 19 19 19 19 19 19 19 19 19 19 19 19 19 19 19 19 19 19 19 20 19 19 19 19 19 19 19 19 19 19 19 19 19 19 19 19 20 19 19 19 19 19 19 19 19 19 19 19 19 19 19 19 19 19 19 19 19 19 19 19 19 20 19 19 19 19 19 19 19 19 
19 19 19 19 19 19 19 19 19 19 19 19 19 19 19 19 19 19 19 19 19 19 19 19 19 19 19 19 19 19 19 19 19 19 19 19 19 19 19 19 19 19 19 19 19 19 19 19 19 19 19 19 19 19 19 19 19 19 19 19 19 19 19 19 19 19 19 19 19 19 19 19 19 19 19 19 19 20 19 19 19 19 19 19 19 19 19 19 19 19 19 19 19 19 19 19 19 19 19 19 
19 19 19 19 19 19 19 19 19 19 19 19 19 19 19 19 19 19 19 19 19 19 19 19 19 19 19 19 19 19 19 19 19 19 19 19 19 20 19 19 19 19 19 19 19 19 19 19 19 19 19 19 19 19 19 19 19 19 20 19 19 19 19 19 19 19 19 19 19 19 19 19 19 19 19 19 19 19 19 19 19 19 19 19 19 19 19 20 19 19 19 19 19 19 19 19 19 20 19 19 
19 19 19 19 19 19 19 19 19 19 19 19 19 19 19 19 19 19 20 19 19 19 19 19 19 19 19 19 19 19 19 19 19 19 19 19 19 19 19 19 19 19 19 19 19 19 19 19 19 19 19 19 19 19 19 19 19 19 19 19 19 19 19 19 19 19 19 19 19 19 19 19 19 19 19 19 19 19 19 19 19 19 19 19 19 19 19 19 19 19 19 19 19 19 19 19 19 19 19 19 
19 19 19 19 19 19 19 19 19 20 19 19 19 19 19 19 19 19 19 19 19 19 19 19 19 19 19 19 21 30 30 30 30 30 30 30 30 30 30 30 22 19 19 19 19 19 19 19 19 19 19 19 19 19 19 19 21 30 30 30 22 19 19 19 19 19 19 19 19 19 20 19 19 19 19 19 19 19 19 19 19 19 19 19 20 19 19 19 19 19 19 19 19 19 19 19 19 19 19 19 
19 19 19 19 19 19 19 19 19 19 19 19 21 30 30 30 30 30 30 30 30 30 22 19 19 19 19 20 28 33 33 33 33 33 33 33 0 18 9 0 31 30 22 19 19 19 19 19 19 19 19 19 20 21 30 30 29 18 9 1 31 30 30 30 30 30 30 22 19 19 19 19 19 19 19 19 20 19 19 19 19 19 19 19 19 19 19 19 19 19 19 20 19 19 19 19 19 19 19 19 
19 19 19 19 19 19 19 19 19 19 21 30 29 16 16 16 16 16 16 16 16 1 32 19 19 19 19 19 28 33 25 26 26 26 26 26 27 13 11 0 33 0 32 19 19 19 19 19 19 19 19 21 30 29 0 0 0 13 11 0 33 33 33 33 0 0 16 31 22 19 19 19 19 19 19 19 21 30 30 30 30 22 19 19 19 19 19 19 19 19 19 19 19 19 19 19 19 19 19 19 
19 19 19 20 19 19 19 19 19 21 29 16 16 16 4 8 8 8 8 8 9 16 31 30 30 30 30 30 29 33 32 19 19 19 20 19 24 26 26 26 26 26 23 20 19 21 30 30 30 30 30 29 0 0 0 33 0 0 0 0 25 26 26 27 0 0 0 16 31 30 30 30 30 30 30 30 29 16 16 16 16 31 30 30 30 22 19 19 19 19 19 19 19 19 19 19 19 19 19 19 
19 19 19 19 19 19 19 21 30 29 16 16 4 8 15 6 12 12 12 7 5 9 16 16 16 16 16 16 16 18 31 30 30 30 30 30 30 30 30 30 30 30 30 30 30 29 16 16 0 0 0 0 0 0 0 33 0 16 16 16 31 22 19 28 16 0 0 16 16 16 16 16 16 16 16 16 16 4 8 8 8 8 8 18 9 31 30 22 19 19 19 19 19 19 19 19 19 20 19 19 
19 19 19 19 19 19 21 29 16 16 4 8 15 6 12 11 16 16 16 13 7 5 9 18 18 0 0 18 0 0 16 16 16 16 16 16 16 16 16 16 16 16 16 16 16 16 1 0 0 0 0 0 16 16 16 16 0 16 16 16 16 32 20 24 27 16 0 4 8 8 8 8 8 8 8 8 8 15 6 12 12 12 12 12 11 16 16 31 22 19 19 19 19 19 19 19 19 19 19 19 
19 19 19 19 19 19 28 2 16 4 18 3 6 11 16 16 16 16 16 16 13 7 10 16 16 16 16 16 16 16 16 16 16 16 16 4 8 9 0 0 0 2 0 0 0 0 0 0 0 16 16 16 16 16 16 16 16 16 16 16 16 31 22 19 24 27 16 13 12 12 12 12 12 12 12 12 7 33 10 16 16 16 16 16 16 16 1 16 32 19 19 19 19 19 19 19 19 19 19 19 
19 19 19 19 19 19 28 16 16 14 3 33 10 16 0 16 16 0 0 16 16 14 10 16 0 16 16 16 0 16 16 16 16 4 8 15 6 11 0 16 16 16 16 16 16 16 16 16 16 16 16 16 16 16 2 16 16 16 16 16 16 16 31 22 19 24 27 16 16 16 16 16 16 16 16 16 14 33 5 9 16 16 16 16 18 18 18 18 31 22 19 19 19 19 19 19 19 19 19 19 
19 19 19 19 19 19 28 16 4 15 6 12 11 16 16 16 2 16 16 0 16 14 10 16 16 2 16 16 16 16 0 4 8 15 6 12 11 16 16 16 18 18 18 18 18 18 18 18 18 18 18 18 18 16 16 16 16 16 16 16 16 16 16 31 22 19 24 26 27 16 16 16 16 16 16 16 13 7 3 5 9 16 16 16 18 18 33 18 16 32 19 19 19 19 19 19 19 19 19 19 
19 19 19 19 20 19 28 16 14 6 11 16 16 16 16 16 16 16 16 16 4 15 5 9 0 16 16 0 16 4 8 15 3 33 10 16 16 16 16 16 18 33 33 33 33 33 18 4 8 8 8 9 18 16 16 16 16 16 16 16 16 1 16 16 32 19 19 19 24 27 16 16 16 16 16 16 16 13 7 3 5 9 16 16 18 33 33 18 16 32 19 19 19 19 19 19 19 19 19 19 
19 19 19 19 19 19 28 16 14 10 16 16 0 0 16 16 16 4 8 8 15 33 33 5 8 8 8 8 8 15 3 3 33 3 10 16 16 2 16 16 18 33 33 33 33 33 18 14 3 3 3 10 18 16 16 16 16 16 16 16 16 16 16 16 31 22 19 20 19 24 26 27 16 16 16 2 16 16 13 7 3 33 8 9 18 33 33 18 16 32 19 19 19 19 19 20 19 19 19 19 
19 19 19 19 19 19 28 16 14 10 16 16 16 16 16 16 4 15 6 12 7 33 33 6 12 12 12 12 12 7 3 3 3 3 10 0 16 16 16 16 18 33 33 33 33 33 33 14 18 3 3 10 33 18 18 16 16 16 16 16 16 16 16 16 16 31 22 19 19 19 19 24 27 16 16 16 16 16 16 13 12 12 33 11 18 33 18 18 16 32 19 19 19 19 19 20 19 19 19 19 
19 19 19 19 19 19 28 16 14 10 16 16 16 0 16 4 15 6 11 16 13 7 6 11 16 16 16 16 16 13 12 12 12 7 5 8 9 16 16 16 18 33 33 33 33 33 18 14 3 3 3 10 18 16 18 16 2 16 16 16 16 16 16 16 16 16 32 19 19 19 20 19 28 16 16 16 16 16 16 18 16 16 16 18 18 18 16 16 25 23 19 19 19 19 19 19 19 19 19 19 
19 19 20 19 19 19 28 16 14 10 16 0 16 16 16 14 6 11 16 16 16 14 10 16 16 16 0 16 16 16 16 16 16 13 12 7 5 9 16 16 18 33 33 33 33 33 18 13 12 12 12 11 18 16 18 16 16 16 16 16 16 16 16 16 16 16 32 19 19 19 19 19 24 27 16 16 16 16 16 18 16 16 16 16 16 16 16 16 32 19 19 19 19 19 19 19 19 19 19 19 
19 19 19 19 19 19 28 16 14 10 16 16 16 16 16 14 10 16 16 0 16 14 10 16 16 2 16 16 0 16 0 16 16 0 16 13 7 5 9 16 18 18 18 18 18 18 18 18 18 18 18 18 18 16 18 18 18 18 18 18 4 8 9 16 1 16 31 22 19 19 19 19 19 24 27 16 16 16 16 18 16 16 16 16 16 16 16 16 32 19 19 19 19 19 19 19 19 19 19 19 
19 19 19 19 19 19 28 16 14 5 8 9 16 1 16 14 10 16 16 16 16 14 5 9 16 16 16 16 16 16 0 16 0 16 16 16 13 7 10 16 16 16 16 16 16 16 16 16 16 16 16 16 16 16 18 16 16 16 16 16 14 18 5 8 9 16 16 31 22 19 19 19 19 19 24 26 27 16 16 18 18 18 18 9 16 16 16 25 23 19 19 19 19 19 19 19 19 19 19 19 
19 19 19 19 19 19 28 16 13 12 7 5 9 16 16 14 10 16 0 16 16 13 7 5 9 16 16 16 0 16 16 0 16 16 16 0 16 14 5 9 16 16 1 16 16 16 16 16 16 16 16 16 16 18 18 16 16 16 16 16 13 12 12 7 5 9 16 16 31 22 19 20 19 19 19 19 24 27 16 16 16 16 13 11 16 16 25 23 19 19 19 19 19 19 19 19 19 19 19 19 
19 19 19 19 19 19 28 16 16 16 13 7 5 9 16 14 10 16 16 16 16 16 13 7 5 8 9 16 16 16 16 16 16 16 16 16 16 13 7 5 8 9 16 16 16 0 0 16 16 16 16 16 16 0 16 16 16 16 16 2 16 16 16 13 7 5 9 16 16 31 30 22 19 19 19 19 19 24 26 27 16 16 16 16 25 26 23 19 19 19 19 19 19 19 19 19 19 19 19 19 
19 19 19 19 19 19 24 26 26 27 16 13 7 5 8 15 10 16 0 16 16 0 16 13 12 7 5 8 8 8 8 8 8 8 8 9 16 16 14 3 3 5 9 16 0 0 0 0 0 0 0 0 0 0 16 16 16 16 16 16 16 16 16 16 13 7 5 9 16 16 16 31 22 19 19 19 19 19 20 24 26 26 26 26 23 19 19 19 19 19 19 19 19 19 19 19 19 19 19 19 
19 20 19 19 19 19 19 19 19 28 16 16 13 7 33 33 10 16 16 16 16 16 16 16 16 13 12 12 12 12 12 12 7 18 3 10 16 16 14 3 33 33 10 0 2 0 0 0 0 0 0 0 0 0 0 0 0 0 16 16 16 16 16 16 16 13 7 5 9 16 16 16 31 30 30 30 22 19 19 19 19 19 19 19 19 19 19 19 19 19 20 19 19 19 19 19 19 20 19 19 
19 19 19 19 19 19 19 19 19 28 16 0 16 14 33 33 5 8 8 8 8 8 9 16 16 16 16 16 16 16 16 16 14 3 3 10 16 16 13 7 33 33 11 0 0 0 16 16 16 16 0 0 1 0 0 0 33 0 16 16 16 16 16 16 16 16 13 7 5 9 16 16 16 16 16 16 31 30 30 30 30 30 30 30 30 30 30 30 30 30 22 19 19 19 19 19 19 19 19 19 
19 19 19 19 19 20 19 19 19 24 27 2 16 13 12 12 12 12 12 12 12 7 5 9 16 0 2 16 18 9 16 16 13 12 12 11 16 16 0 13 12 11 0 0 16 16 16 16 16 16 0 0 0 0 16 16 0 0 16 16 0 0 0 0 16 16 16 13 7 5 8 9 16 16 16 16 16 16 16 16 16 16 18 16 16 16 16 16 16 16 31 22 19 19 19 19 19 19 19 19 
19 19 19 19 19 19 19 19 19 19 24 27 16 16 16 16 16 16 16 16 16 13 7 5 9 16 16 16 13 11 18 18 16 16 16 16 16 16 0 0 0 0 0 16 0 0 16 16 16 16 16 0 0 0 16 16 16 0 0 0 0 0 16 0 0 0 16 16 13 12 7 5 8 8 8 33 33 8 8 8 8 8 33 8 8 8 8 33 8 8 9 31 22 19 19 19 19 19 19 19 
19 19 19 19 19 19 19 19 19 19 19 24 26 26 26 26 26 26 26 26 27 16 13 7 5 8 9 16 16 16 16 18 18 18 18 18 18 16 0 0 0 0 0 16 16 16 0 16 16 0 16 0 1 0 16 16 16 0 2 0 0 16 16 16 0 33 0 16 16 16 13 12 12 12 12 12 12 12 12 12 12 12 18 12 12 12 12 12 12 7 18 9 32 19 19 19 19 19 19 19 
19 19 19 19 19 19 19 19 19 20 19 19 19 19 19 19 19 19 19 19 28 16 16 13 12 7 5 8 8 9 16 16 16 16 16 16 18 16 0 0 16 16 18 16 16 16 16 0 16 16 0 0 0 0 16 16 16 16 0 0 0 16 16 16 16 0 0 0 16 16 16 16 16 16 16 16 16 16 16 16 16 16 18 16 16 16 16 16 16 13 12 11 32 19 19 19 19 19 19 19 
19 19 19 19 19 19 19 19 19 21 30 30 22 19 19 19 19 19 20 19 24 27 16 16 16 13 12 12 7 5 8 8 8 8 9 16 0 0 0 16 16 16 18 18 18 16 16 16 16 16 16 16 0 0 0 16 16 0 0 0 16 16 2 16 16 16 16 16 16 16 16 25 26 26 26 26 26 26 26 26 26 26 26 26 26 26 26 26 27 16 16 0 32 19 19 19 19 19 19 19 
19 19 19 19 19 19 20 21 30 29 16 16 31 30 22 19 20 19 19 19 19 24 27 16 16 16 16 16 13 12 12 7 18 3 10 16 16 0 0 16 16 16 16 16 18 9 16 16 16 0 0 0 0 0 0 16 0 0 0 0 16 16 16 16 16 16 25 26 26 26 26 23 19 19 19 19 19 19 19 19 19 19 19 19 19 19 19 19 24 27 16 18 32 19 19 19 19 20 19 19 
19 19 19 19 19 19 21 29 16 16 16 16 16 16 32 19 19 19 21 30 30 22 24 26 26 26 26 27 16 16 16 14 3 3 10 16 0 0 0 16 0 16 16 16 13 11 16 16 0 0 0 0 0 0 0 0 0 0 0 0 16 16 16 25 26 26 23 20 19 19 19 19 19 19 19 19 19 19 20 19 19 19 19 19 19 19 20 19 19 24 27 18 32 19 19 19 19 19 19 19 
19 19 19 19 19 19 28 16 16 4 8 8 9 16 31 22 21 30 29 16 16 31 22 19 19 19 20 24 27 16 16 13 12 12 11 16 0 0 0 0 16 16 16 16 16 16 16 0 0 2 0 0 0 0 1 0 16 16 0 0 16 25 26 23 19 19 19 19 19 19 19 19 19 19 19 19 19 21 30 30 30 22 19 19 19 19 19 19 19 19 28 18 32 19 19 19 19 19 19 19 
19 20 19 19 19 19 28 16 16 14 18 3 10 16 16 31 29 16 16 16 16 16 31 30 30 30 22 19 24 27 16 16 16 16 16 16 0 0 0 16 0 16 16 16 16 0 16 0 0 0 0 0 16 16 16 16 16 16 0 0 16 32 19 19 19 19 19 19 19 19 19 19 19 21 30 30 30 29 18 16 16 31 22 19 19 19 19 19 19 19 28 18 32 19 19 19 19 19 19 19 
19 19 19 19 19 19 28 16 16 13 12 12 11 18 16 16 16 16 16 16 16 0 16 16 16 16 31 22 19 24 27 16 16 16 16 0 0 0 0 0 0 0 0 0 0 16 0 0 0 0 0 16 16 16 16 16 16 16 16 0 16 32 19 19 19 19 19 19 19 19 20 19 21 29 16 16 16 16 18 4 8 9 31 22 19 19 19 19 21 30 29 18 32 19 19 19 19 19 19 19 
19 19 19 19 19 19 28 16 16 16 16 16 16 18 18 18 18 18 18 18 18 0 0 16 16 16 16 31 22 19 24 27 16 16 16 0 0 0 0 0 1 0 0 0 0 0 16 0 0 0 16 16 0 0 16 16 16 16 16 0 25 23 19 19 20 19 19 19 19 19 19 19 28 16 4 33 8 9 18 14 18 5 9 32 19 20 30 30 29 0 0 0 32 19 19 19 19 19 19 19 
19 19 19 19 19 19 28 16 16 16 16 16 16 18 18 33 33 33 33 33 18 0 0 16 16 16 16 16 32 20 19 28 2 16 16 0 0 16 16 16 16 16 16 0 0 0 4 8 9 0 16 16 16 16 18 9 16 0 16 0 31 30 30 30 30 30 30 30 30 30 30 30 29 4 33 3 3 10 18 14 3 3 10 31 30 29 16 16 16 0 16 16 32 19 19 19 19 19 19 19 
19 19 19 19 20 19 28 16 16 16 16 16 16 18 18 33 33 33 33 33 18 0 33 0 16 16 16 16 32 19 19 24 27 16 0 0 0 0 16 0 16 16 0 16 0 0 14 3 10 0 16 0 0 16 13 11 16 2 16 0 33 33 33 33 33 33 33 33 33 33 33 33 33 14 33 3 18 10 18 14 33 33 33 9 0 0 0 2 0 0 0 16 32 19 19 19 19 19 19 19 
19 19 19 19 19 19 28 16 16 16 16 16 16 18 18 33 33 33 33 33 18 16 0 0 16 16 16 16 32 19 19 20 28 16 0 0 0 16 16 16 16 16 16 16 0 0 13 12 11 0 16 16 16 18 18 16 16 0 16 0 25 26 26 26 26 26 26 26 26 26 26 26 27 13 33 7 3 10 18 14 33 33 33 11 16 16 16 25 27 16 16 0 32 19 19 19 20 19 19 19 
19 19 19 19 19 19 24 26 26 27 16 16 16 18 18 33 33 33 33 33 18 16 16 0 0 16 16 16 32 19 19 19 28 16 0 0 0 0 16 16 2 16 16 16 16 0 0 1 0 0 0 16 16 18 16 16 16 16 16 0 32 19 19 19 19 19 19 19 19 19 19 19 24 27 16 13 33 11 18 13 12 12 11 16 25 26 26 23 28 0 0 16 32 19 19 19 19 19 19 19 
19 19 19 19 19 19 19 19 19 28 16 16 16 18 18 18 18 33 18 18 18 16 16 0 0 16 16 16 32 19 19 19 28 16 0 2 0 16 16 16 16 16 16 16 16 0 0 0 0 0 0 0 0 0 16 16 0 0 0 33 32 19 20 19 19 19 19 19 19 19 19 19 19 24 26 27 16 16 18 16 16 16 25 26 23 19 20 19 24 27 16 0 32 19 19 19 19 19 19 19 
19 19 19 19 19 19 19 19 19 24 27 16 16 18 18 18 4 8 9 16 16 16 16 0 0 16 16 16 31 22 19 19 28 16 0 0 0 0 16 0 16 16 16 0 0 0 0 0 0 0 0 0 0 0 0 0 0 0 33 0 32 19 19 19 19 19 19 20 19 19 19 19 19 19 19 24 26 26 26 26 26 26 23 19 19 19 19 19 19 24 27 16 32 19 19 19 19 19 20 19 
19 19 19 19 19 19 19 19 19 19 24 27 16 16 16 16 14 3 10 16 16 0 16 0 0 0 0 16 16 31 30 30 29 16 0 33 0 0 0 0 0 0 0 0 0 0 0 16 0 0 2 0 0 0 0 0 0 0 0 0 31 22 19 19 19 19 19 19 19 19 19 19 19 19 19 19 19 19 19 20 19 19 19 19 19 19 19 19 19 19 28 0 32 19 19 19 19 19 19 19 
19 19 19 19 19 19 19 19 19 19 19 28 16 16 16 16 13 7 10 16 16 16 0 0 0 0 0 0 18 33 33 33 33 18 0 0 33 0 0 0 0 0 0 0 0 0 16 16 16 16 0 0 0 0 16 16 16 0 0 16 16 32 19 19 19 19 19 19 19 19 19 19 19 19 19 19 19 19 19 19 19 19 19 19 20 19 19 19 20 21 29 16 32 19 19 19 19 19 19 19 
19 19 19 19 20 19 19 19 19 19 19 24 27 16 16 16 16 14 5 9 16 0 0 0 16 0 0 0 16 25 26 26 27 16 16 0 0 16 16 16 16 16 16 16 16 16 16 16 16 16 16 16 16 0 16 16 16 16 0 16 16 31 22 19 19 19 19 19 19 20 19 19 19 19 19 19 19 19 19 19 19 19 19 19 19 19 19 19 19 28 18 9 32 19 19 19 19 19 19 19 
19 19 19 19 19 19 19 19 19 19 19 19 24 27 16 16 16 13 7 5 9 0 0 16 16 16 16 0 16 32 20 19 28 16 16 0 0 16 16 16 16 16 16 16 25 26 26 26 26 27 16 16 0 16 16 16 16 16 0 0 16 16 31 30 30 22 19 19 19 19 19 19 19 19 19 20 19 19 19 19 19 19 19 19 19 19 19 21 30 29 13 11 32 19 19 19 19 19 19 19 
19 19 19 19 19 19 19 19 20 19 19 19 19 28 16 16 16 16 14 3 10 16 1 16 16 16 16 16 16 32 19 19 28 16 16 0 0 16 16 16 2 16 25 26 23 21 30 30 22 24 26 27 16 1 16 16 16 16 16 0 0 16 16 16 16 31 30 30 30 30 30 30 30 30 30 30 30 30 30 30 30 30 30 30 30 30 30 29 16 16 16 18 32 19 19 19 19 19 19 19 
19 19 19 19 19 19 19 19 19 19 19 19 19 28 16 16 16 16 14 3 10 16 16 16 16 16 16 16 16 32 19 19 28 16 16 0 0 16 16 16 16 25 23 21 30 29 16 16 31 30 22 24 27 16 16 16 16 0 16 0 0 16 16 16 16 16 16 16 16 0 0 1 0 33 0 0 0 16 16 16 16 16 16 16 16 16 16 16 16 18 18 18 32 19 19 19 19 19 19 19 
19 19 19 19 19 19 19 19 19 19 19 19 19 28 16 16 16 16 14 3 10 16 16 16 16 16 16 16 16 32 19 19 28 16 16 0 0 16 16 16 25 23 21 29 16 16 16 18 9 16 31 22 24 27 0 16 16 16 16 0 0 0 16 16 16 0 0 0 0 0 0 0 0 0 33 0 0 0 0 0 16 16 16 16 16 16 16 18 18 18 16 16 32 19 19 19 19 19 19 19 
19 19 19 19 19 19 19 19 19 19 19 19 19 28 16 16 0 16 14 3 10 16 16 16 16 16 16 16 16 32 19 20 28 16 16 16 0 0 16 16 31 30 29 16 18 18 18 13 11 16 16 32 19 24 27 16 16 16 16 16 0 0 16 0 0 0 16 16 16 16 16 25 26 26 26 27 16 16 16 0 0 0 0 16 16 16 16 0 16 16 16 16 32 19 19 19 19 19 19 19 
19 19 19 19 19 19 19 19 19 19 19 19 20 28 16 16 16 16 14 3 10 16 16 16 16 16 18 9 16 32 19 19 28 16 16 16 0 0 0 0 16 16 18 18 18 16 25 26 26 26 26 23 19 19 28 16 16 16 16 16 0 0 0 0 16 16 16 16 16 25 26 23 19 19 19 24 26 27 16 16 16 0 0 0 16 16 0 0 0 16 16 16 32 19 19 19 19 19 19 19 
19 19 19 19 19 19 19 19 19 19 19 19 19 28 16 16 16 16 14 33 10 18 18 18 18 18 13 11 16 32 19 19 28 16 16 16 0 0 0 0 0 2 18 25 26 26 23 19 19 19 19 19 20 19 28 16 16 16 16 16 16 0 0 16 16 16 16 16 16 32 19 19 19 19 20 19 19 28 16 16 16 0 0 0 16 16 0 0 0 0 16 16 32 19 19 19 19 19 19 19 
19 19 19 19 19 20 19 19 19 19 19 19 19 28 16 0 16 16 14 3 10 16 16 16 16 16 16 16 16 32 19 19 28 16 16 0 0 0 16 0 0 16 16 32 19 19 19 21 30 30 30 30 30 30 29 0 16 0 16 16 16 16 0 0 16 0 16 16 16 32 19 19 19 19 19 19 19 28 16 16 16 0 0 0 18 0 33 0 16 0 0 16 32 19 19 20 19 19 19 19 
19 19 19 19 19 19 19 19 19 19 19 19 19 28 16 16 16 16 14 3 10 16 16 16 16 16 16 16 16 32 19 19 28 16 16 0 0 16 16 16 16 16 25 23 19 19 20 28 33 33 33 33 33 33 33 0 0 16 16 16 16 16 0 0 16 16 16 16 16 31 22 20 19 19 19 19 21 29 16 16 0 0 16 16 16 0 0 16 16 0 0 16 32 19 19 19 19 19 19 19 
19 19 19 19 19 19 19 19 19 19 19 19 19 28 16 16 16 16 14 3 10 0 0 0 0 0 16 16 16 32 19 19 28 16 16 0 0 16 16 16 2 16 32 19 19 19 19 28 33 25 26 26 26 26 27 0 33 0 16 16 16 16 0 33 0 16 16 16 16 16 31 30 30 30 30 30 29 16 0 0 0 0 0 16 0 0 0 16 16 0 0 16 32 19 19 19 19 19 19 19 
19 19 19 19 19 19 19 19 19 19 19 19 19 28 16 16 0 16 14 3 10 16 16 0 0 0 0 16 16 32 19 19 28 16 2 0 0 16 16 16 16 16 32 19 19 19 21 29 33 31 22 19 20 19 28 16 0 2 16 16 16 16 0 33 0 16 16 16 16 16 16 16 16 16 16 16 0 0 0 0 0 0 0 16 0 0 16 16 0 0 0 16 32 19 19 19 19 19 19 19 
19 19 19 19 19 19 19 19 19 19 19 19 20 28 16 16 16 16 14 3 10 16 16 16 16 0 0 16 16 32 19 19 28 16 0 0 16 16 16 16 16 16 32 20 19 21 29 33 33 33 31 22 19 21 29 16 0 0 16 16 0 16 0 0 0 16 16 16 16 16 16 16 16 16 16 0 0 0 2 0 16 16 16 16 0 0 16 16 0 0 0 16 32 19 19 19 19 20 19 19 
19 19 19 19 19 19 19 19 19 19 19 19 19 28 16 16 16 16 14 3 10 16 16 0 16 16 0 0 16 32 20 19 28 16 0 0 16 16 16 16 16 16 32 19 19 28 33 33 18 33 33 32 19 28 16 16 0 0 16 16 16 16 0 0 16 16 16 16 16 16 16 0 16 16 0 0 16 25 27 16 16 16 1 16 0 0 16 16 0 0 16 25 23 19 19 19 19 19 19 19 
19 19 19 19 19 19 19 19 19 19 19 19 19 28 16 16 16 16 14 3 10 16 16 16 16 16 0 33 16 32 19 19 28 16 16 0 0 16 16 16 16 16 31 22 19 24 27 33 33 33 25 23 21 29 16 0 0 16 16 16 16 16 0 0 16 16 25 26 26 27 16 16 16 0 0 16 25 23 24 26 27 16 16 16 0 0 16 16 0 0 16 32 19 19 19 19 19 19 19 19 
19 19 19 19 19 19 19 19 19 19 19 19 19 28 16 16 16 16 14 3 10 16 2 16 16 16 0 0 16 32 19 19 28 16 16 0 0 0 16 16 16 16 0 31 22 19 24 26 26 26 23 21 29 16 0 0 0 16 16 16 16 0 0 16 16 25 23 19 19 24 27 16 0 0 16 16 32 19 19 20 24 27 16 16 0 0 16 16 0 0 16 32 19 19 19 19 19 19 19 19 
19 19 19 19 19 19 19 19 19 19 20 19 19 28 16 16 0 16 14 3 10 16 16 16 16 16 16 16 16 32 19 19 28 16 16 16 0 0 0 0 0 0 0 0 31 30 22 19 20 21 30 29 16 0 0 0 16 16 16 16 0 0 0 16 16 32 20 19 19 19 24 27 0 0 16 25 23 19 19 19 19 24 27 16 16 0 16 0 0 0 16 32 19 19 19 19 19 19 19 19 
19 19 19 19 19 19 19 19 19 19 19 19 19 28 16 16 16 16 13 12 11 16 16 16 16 16 16 16 16 32 19 19 28 16 16 16 16 16 0 0 0 33 0 0 0 0 31 30 30 29 16 16 16 0 0 16 16 16 16 0 0 0 16 16 25 23 19 19 19 19 19 28 33 33 16 32 19 19 19 19 19 19 28 16 16 0 16 0 0 2 16 32 19 19 19 19 19 19 19 19 
19 19 20 19 19 19 19 19 19 21 30 30 30 29 18 18 18 18 18 33 18 18 18 18 18 18 18 18 18 32 19 19 28 16 16 0 16 16 16 0 0 0 0 0 0 0 0 0 16 0 16 0 0 0 0 16 16 16 0 0 0 16 16 16 32 19 19 19 19 19 19 28 33 33 25 23 19 20 19 19 19 21 29 16 16 0 16 0 33 16 16 32 19 19 19 19 19 19 19 19 
19 19 19 19 19 19 19 19 19 28 16 16 16 16 16 16 4 8 8 8 8 8 9 16 16 16 16 16 16 32 19 20 28 16 16 16 16 16 16 16 16 0 0 16 0 0 0 0 0 0 0 0 0 0 0 16 16 16 0 0 16 16 16 16 32 19 19 19 20 19 21 29 0 0 32 19 19 19 19 21 30 29 16 16 16 0 16 33 0 16 16 32 19 19 19 19 19 19 19 19 
19 19 19 19 19 19 19 20 19 28 16 16 16 16 0 16 14 3 33 33 33 3 10 16 16 16 16 16 16 32 19 19 28 16 16 16 16 16 16 16 16 16 16 16 16 16 16 16 0 0 0 2 0 0 0 17 17 0 0 0 16 0 16 16 31 22 19 19 19 19 28 16 0 0 31 22 19 19 21 29 16 16 16 16 16 0 16 0 0 16 16 32 19 19 19 19 19 19 19 19 
19 19 19 19 19 19 19 19 19 28 16 16 16 16 16 16 14 3 33 33 33 3 10 16 16 16 16 16 16 32 19 19 28 16 16 16 16 16 16 16 16 16 16 16 16 16 16 16 16 16 16 16 16 16 16 16 16 0 0 16 16 16 16 16 16 31 30 22 19 19 28 16 0 0 16 31 30 30 29 16 16 16 16 16 0 0 16 0 16 16 16 32 19 19 19 19 19 19 19 19 
19 19 19 19 19 19 19 19 19 28 16 16 16 16 16 16 14 3 3 33 3 3 10 16 16 0 16 16 16 32 19 19 28 16 0 16 16 16 16 16 1 16 16 16 16 0 16 16 16 16 16 16 16 16 16 16 0 0 0 16 16 16 16 16 2 16 16 31 30 30 29 16 0 0 16 16 16 16 16 16 16 16 16 16 2 0 16 16 16 16 16 32 19 19 19 20 19 19 19 19 
19 19 19 19 19 19 19 21 30 29 16 16 16 16 16 16 13 12 7 3 6 12 11 16 16 16 16 16 25 23 19 19 28 16 16 16 16 2 16 16 18 16 16 16 16 16 16 0 0 18 9 0 16 16 16 0 0 0 0 16 16 16 16 16 16 16 16 16 16 16 16 16 1 0 16 16 16 16 16 16 16 16 16 0 0 16 16 16 16 16 25 23 19 19 19 19 19 19 19 19 
19 19 19 19 19 19 19 28 16 16 16 16 16 16 16 16 16 16 14 3 10 16 16 16 16 16 16 16 32 19 20 19 28 16 16 0 16 16 16 16 18 16 16 16 16 0 1 0 0 13 11 16 16 16 0 0 0 0 2 0 16 16 16 16 16 16 16 16 16 16 16 16 16 0 16 16 16 16 16 0 16 16 0 0 0 16 16 16 16 16 32 19 19 19 19 19 19 19 19 19 
19 19 19 19 19 19 20 28 16 16 16 16 16 16 16 16 16 16 14 3 10 16 16 16 16 16 16 16 32 19 19 19 28 16 1 0 0 16 16 16 18 16 16 16 0 0 33 0 0 0 16 16 16 0 0 0 0 16 0 0 0 16 16 16 0 16 16 16 16 16 16 16 16 0 0 0 0 0 0 0 0 0 0 16 16 16 16 16 16 25 23 19 19 19 19 19 19 19 19 19 
19 19 19 19 19 19 19 28 16 16 16 16 16 16 0 16 16 16 14 3 10 16 16 16 16 16 16 25 23 19 19 19 28 16 0 33 0 16 16 16 18 16 16 16 0 0 16 16 16 16 16 16 0 0 0 0 16 16 16 0 0 0 16 16 16 16 0 0 0 0 2 0 0 0 0 0 0 0 0 16 16 16 16 16 16 16 16 16 25 23 19 19 19 19 19 19 19 19 19 19 
19 19 19 19 19 19 19 28 16 16 16 16 16 16 16 16 16 16 14 3 10 16 16 16 16 16 16 32 20 19 19 19 28 16 0 33 0 16 16 16 18 16 16 16 0 0 16 16 0 16 16 0 0 0 0 16 16 16 0 16 0 0 0 0 0 0 0 0 0 0 0 0 0 16 16 16 16 16 16 16 16 16 16 16 25 26 26 26 23 19 19 19 19 19 19 19 19 19 19 19 
19 19 19 19 19 19 19 28 16 16 16 16 16 16 16 0 0 16 14 3 10 16 16 16 16 16 16 32 19 19 19 21 29 16 0 0 16 16 16 16 18 16 0 16 0 0 16 16 16 16 0 0 0 0 16 16 16 16 16 16 16 0 0 33 0 0 0 0 16 16 16 16 16 16 16 16 16 16 16 16 16 25 26 26 23 19 19 19 19 19 19 19 19 19 19 19 19 19 19 19 
19 20 19 19 19 19 19 28 16 16 1 16 16 0 0 0 0 0 14 3 10 16 16 16 16 16 16 31 30 30 30 29 16 16 0 0 16 16 16 16 18 16 16 16 0 0 16 16 16 0 0 0 0 16 16 16 16 16 16 16 16 16 0 0 0 16 16 16 16 0 0 18 9 0 16 16 16 16 16 25 26 23 19 19 19 19 19 19 19 19 19 19 19 19 19 19 19 19 19 19 
19 19 19 19 19 19 19 28 16 16 16 16 0 0 0 0 0 16 14 3 10 16 0 16 16 16 16 16 16 16 16 16 16 16 0 0 16 16 16 16 18 16 16 16 16 0 0 16 16 0 0 0 0 16 16 2 16 16 16 16 16 16 16 0 16 16 16 0 0 0 0 13 11 16 16 16 16 25 26 23 19 19 19 20 19 19 19 19 19 19 19 19 19 19 19 19 19 19 19 19 
19 19 19 19 19 19 19 28 16 16 16 0 0 0 16 16 16 16 14 3 10 16 16 16 16 16 16 16 16 16 16 16 16 0 0 16 16 2 16 16 18 16 16 16 16 16 0 0 0 0 0 16 0 0 16 16 16 16 16 16 16 16 16 16 16 0 0 0 0 16 16 16 16 16 25 26 26 23 19 19 19 19 19 19 19 19 19 19 19 19 19 19 19 20 19 19 19 19 19 19 
19 19 19 19 19 19 19 28 16 16 16 0 0 16 16 16 16 16 14 3 10 16 16 16 16 16 16 16 16 16 16 16 0 0 0 16 16 16 16 16 18 16 16 16 16 0 0 0 0 0 0 16 0 0 0 16 16 16 16 16 16 0 0 0 0 0 16 16 16 16 16 25 26 26 23 19 19 19 19 19 19 19 19 19 19 19 19 19 19 19 19 19 19 19 19 19 19 19 19 19 
19 19 19 19 19 19 19 28 16 16 16 33 0 16 0 16 16 16 14 3 10 16 16 16 16 16 16 16 16 16 16 16 0 0 16 16 16 16 16 16 18 16 1 16 0 0 0 16 16 16 16 16 16 0 0 0 16 16 16 0 0 0 0 0 0 16 16 16 16 16 25 23 19 19 19 19 19 19 19 19 19 19 19 19 19 19 19 19 19 19 19 19 19 19 19 19 19 19 19 19 
19 19 19 19 19 19 19 28 16 16 16 0 0 16 16 16 16 16 14 3 10 16 2 16 16 16 0 16 16 16 16 16 0 0 16 16 16 0 16 16 18 16 16 0 0 0 16 16 0 16 16 16 16 0 33 0 0 1 0 0 0 0 16 16 16 16 16 25 26 26 23 19 19 19 19 19 19 19 19 20 19 19 19 19 19 19 19 19 19 19 19 19 19 19 19 19 19 19 19 19 
19 19 19 19 19 19 19 28 16 16 4 8 9 16 16 16 16 16 14 3 10 16 16 16 16 16 16 16 16 16 16 0 0 16 16 16 16 16 16 16 18 16 0 0 0 16 16 16 16 16 16 0 0 0 0 33 0 0 16 16 16 16 25 26 26 26 26 23 19 19 19 19 19 19 19 19 19 19 19 19 19 19 19 19 19 19 19 19 19 19 19 19 19 19 19 19 19 19 19 19 
19 19 19 19 19 20 19 28 16 16 14 18 10 16 16 16 16 16 14 3 5 8 8 8 8 8 8 8 8 8 8 8 8 8 8 8 8 8 8 9 18 0 0 0 16 16 16 16 16 16 0 0 0 0 0 0 16 16 25 26 26 26 23 19 19 19 19 19 19 19 19 19 19 19 19 19 19 19 19 19 19 19 19 19 19 19 19 19 19 19 20 19 19 19 19 19 19 19 19 19 
19 19 19 19 19 19 19 28 16 16 13 12 11 16 16 16 16 16 14 33 3 3 3 3 3 3 3 3 3 3 33 3 3 3 3 3 3 3 3 10 33 0 0 16 16 16 16 0 0 0 0 0 16 16 16 16 25 26 23 19 20 20 19 19 19 19 19 19 19 19 19 19 19 19 19 19 19 19 19 19 19 19 19 19 21 30 22 19 19 19 19 19 19 19 19 19 19 19 19 19 
19 19 19 19 19 19 19 28 16 16 16 16 16 16 16 18 18 18 13 12 12 12 12 12 12 12 12 12 12 12 12 12 12 12 12 12 12 12 12 11 18 0 16 16 4 8 8 9 0 0 0 16 16 16 25 26 23 19 19 19 19 19 19 19 19 19 19 19 19 19 19 19 19 19 19 19 19 19 19 19 19 19 19 21 29 0 31 22 19 19 19 19 19 19 19 19 19 19 19 19 
19 19 19 19 19 19 19 28 16 16 16 2 16 16 16 18 16 16 16 16 16 16 16 16 16 16 16 16 16 16 16 16 16 16 16 16 16 16 16 16 18 16 0 16 14 18 3 10 0 2 16 16 16 25 23 20 19 19 19 19 19 19 19 19 19 19 19 19 20 19 19 19 19 19 19 19 19 19 19 19 19 21 30 29 0 0 0 31 30 22 19 19 19 19 19 19 19 19 19 19 
19 19 19 19 19 19 19 28 16 16 16 16 16 16 16 18 16 16 16 16 16 0 16 16 16 16 16 16 16 16 16 16 16 16 16 0 16 16 16 16 18 16 16 16 14 3 3 10 0 16 16 25 26 23 19 19 19 19 19 19 19 19 19 19 19 19 19 19 19 19 19 19 19 19 19 19 19 19 19 19 21 29 0 0 2 0 1 0 0 31 22 19 19 19 19 19 19 19 19 19 
19 19 19 19 19 19 19 28 16 16 16 16 16 16 16 18 16 16 16 16 16 16 16 16 16 16 16 16 16 16 16 16 16 16 16 16 16 16 16 16 18 16 16 16 13 12 12 11 0 16 25 23 19 19 19 19 19 19 19 19 19 19 19 19 19 19 19 19 19 19 19 19 19 19 19 19 19 19 19 21 29 0 0 1 4 8 9 2 0 0 31 22 19 19 19 19 20 19 19 19 
19 19 20 19 19 19 19 28 16 16 16 16 16 16 16 18 16 16 16 16 16 16 16 16 0 16 16 16 16 16 2 16 16 16 16 16 16 16 16 16 18 16 16 16 16 16 16 16 16 16 32 19 19 19 19 19 19 19 19 19 19 19 19 19 19 19 19 19 19 19 19 19 19 19 19 19 19 19 19 28 0 0 0 0 14 3 10 0 0 0 0 32 19 19 19 19 19 19 19 19 
19 19 19 19 19 19 19 28 16 16 16 16 16 16 4 8 9 16 16 16 16 16 16 16 16 16 16 16 16 16 16 16 4 8 8 9 16 16 16 16 18 16 16 16 16 16 16 25 26 26 23 19 19 19 19 19 19 19 19 19 19 19 19 19 19 19 19 19 19 19 19 19 20 19 19 19 19 19 19 24 26 27 0 2 13 12 11 1 0 25 26 23 19 19 19 19 19 19 19 19 
19 19 19 19 19 19 19 24 27 16 16 16 16 16 14 3 5 8 8 8 8 8 8 8 8 8 8 8 8 8 8 8 15 18 3 10 16 16 0 16 18 16 16 16 25 26 26 23 19 20 19 19 19 19 19 19 19 19 19 19 19 19 19 19 19 19 19 19 19 19 19 19 19 19 19 19 19 19 19 19 19 24 27 0 1 0 2 0 25 23 19 19 19 19 19 19 19 19 19 19 
19 19 19 19 19 19 19 19 24 26 27 16 16 16 13 12 12 12 12 12 12 12 12 12 12 12 12 12 12 12 12 12 7 3 3 10 16 16 16 16 18 16 16 25 23 19 19 19 19 19 19 19 19 19 19 19 19 19 19 19 19 20 19 19 19 19 19 19 19 19 19 19 19 19 19 19 19 19 19 19 19 19 24 27 0 0 0 25 23 19 19 19 19 19 19 19 19 19 19 19 
19 19 19 19 19 19 19 19 19 19 24 27 16 16 16 16 16 16 16 16 16 16 16 16 16 16 16 16 16 16 16 16 13 12 12 11 16 1 16 16 18 16 25 23 19 19 19 19 19 19 19 19 19 19 19 19 19 19 19 19 19 19 19 19 19 19 19 19 19 19 19 19 19 19 19 19 19 19 19 19 19 19 19 24 27 0 25 23 19 19 19 19 19 19 19 19 19 19 19 19 
19 19 19 19 19 19 19 19 19 20 19 24 27 16 16 16 16 16 16 16 16 16 16 16 16 16 16 16 0 16 16 16 16 16 16 16 16 16 16 16 25 26 23 19 19 19 19 19 19 19 19 19 19 19 19 19 19 19 19 19 19 19 19 19 19 19 19 19 19 19 19 19 19 19 19 19 19 19 19 19 19 19 19 19 24 26 23 19 19 19 19 19 19 19 19 19 19 19 19 19 
19 19 19 19 19 19 19 19 19 19 19 19 24 26 26 26 26 27 16 16 16 16 16 16 16 16 16 16 16 16 16 16 16 16 16 16 16 16 25 26 23 19 19 19 19 19 20 19 19 19 19 19 20 19 19 19 19 19 19 19 19 19 19 19 19 19 19 19 19 19 19 19 19 19 20 19 19 19 19 19 19 19 19 19 19 19 19 19 20 19 19 19 19 19 20 19 19 19 19 19 
19 19 19 19 19 19 19 19 19 19 19 19 19 19 19 19 19 24 26 26 26 26 26 26 26 26 26 26 26 26 26 26 26 26 26 26 26 26 23 19 19 19 19 19 19 19 19 19 19 19 19 19 19 19 19 19 19 19 19 19 19 19 19 19 19 19 19 19 19 19 19 19 19 19 19 19 19 19 19 19 19 19 19 19 19 19 19 19 19 19 19 19 19 19 19 19 19 19 19 19 
19 19 19 19 19 19 19 19 19 19 19 19 19 19 19 19 19 19 19 19 19 19 19 19 19 19 19 19 19 19 19 19 19 19 19 19 19 19 19 19 19 19 19 19 19 19 19 19 19 19 19 19 19 19 19 19 19 19 19 19 20 19 19 19 19 19 19 19 19 19 19 19 19 19 19 19 19 19 19 19 19 19 19 19 19 19 19 19 19 19 19 19 19 19 19 19 19 19 19 19 
19 19 19 20 19 19 19 19 19 19 19 19 19 19 19 19 19 19 19 20 19 19 19 19 19 19 19 19 19 19 19 20 19 19 19 19 19 19 19 19 19 19 19 19 19 19 19 19 19 19 19 19 19 19 19 19 19 19 19 19 19 19 19 19 19 19 19 19 19 19 19 19 19 19 19 19 19 19 19 19 19 19 19 19 19 19 19 19 19 19 19 19 19 19 19 19 19 19 19 19 
19 19 19 19 19 19 19 19 19 19 19 20 19 19 19 19 19 19 19 19 19 19 19 19 19 19 19 19 19 19 19 19 19 19 19 19 19 19 19 19 19 19 19 19 19 19 19 19 19 19 19 19 19 19 19 19 19 19 19 19 19 19 19 19 19 19 19 19 19 19 19 19 19 19 19 19 19 19 19 20 19 19 19 19 19 19 19 19 19 19 19 19 19 19 19 19 19 19 19 19 
19 19 19 19 19 19 19 19 19 19 19 19 19 19 19 19 19 19 19 19 19 19 19 19 19 19 19 19 19 19 19 19 19 19 19 19 20 19 19 19 19 19 19 19 19 19 19 19 19 19 19 20 19 19 19 19 19 19 19 19 19 19 19 19 19 19 19 19 19 19 19 19 19 19 19 19 19 19 19 19 19 19 19 19 19 19 19 19 19 19 19 19 20 19 19 19 19 19 19 19 
19 19 19 19 19 19 19 19 19 19 19 19 19 19 19 19 19 19 19 19 19 19 19 19 19 19 19 19 19 19 19 19 19 19 19 19 19 19 19 19 19 19 19 19 19 19 19 19 19 19 19 19 19 19 19 19 19 19 19 19 19 19 19 19 19 19 19 19 19 19 19 19 19 19 19 19 19 19 19 19 19 19 19 19 19 19 19 19 19 19 19 19 19 19 19 19 19 19 19 19 
